data;regione;ricoverati_con_sintomi;terapia_intensiva;totale_ospedalizzati;isolamento_domiciliare;totale_positivi;variazione_totale_positivi;dimessi_guariti;deceduti;totale_casi;tamponi;casi_testati;nuovi_casi;nuovi_tamponi;nuovi_deceduti;nuovi_dimessi_guariti;nuovi_terapia_intensiva
2020-02-24;Abruzzo;0;0;0;0;0;0;0;0;0;5;;0,0;5,0;0,0;0,0;0,0
2020-02-25;Abruzzo;0;0;0;0;0;0;0;0;0;5;;0,0;0,0;0,0;0,0;0,0
2020-02-26;Abruzzo;0;0;0;0;0;0;0;0;0;13;;0,0;8,0;0,0;0,0;0,0
2020-02-27;Abruzzo;1;0;1;0;1;1;0;0;1;33;;1,0;20,0;0,0;0,0;0,0
2020-02-28;Abruzzo;1;0;1;0;1;0;0;0;1;33;;0,0;0,0;0,0;0,0;0,0
2020-02-29;Abruzzo;2;0;2;0;2;1;0;0;2;43;;1,0;10,0;0,0;0,0;0,0
2020-03-01;Abruzzo;3;0;3;2;5;3;0;0;5;52;;3,0;9,0;0,0;0,0;0,0
2020-03-02;Abruzzo;3;0;3;2;5;0;0;0;5;52;;0,0;0,0;0,0;0,0;0,0
2020-03-03;Abruzzo;5;0;5;1;6;1;0;0;6;52;;1,0;0,0;0,0;0,0;0,0
2020-03-04;Abruzzo;7;0;7;0;7;1;0;0;7;85;;1,0;33,0;0,0;0,0;0,0
2020-03-05;Abruzzo;8;0;8;0;8;1;0;0;8;96;;1,0;11,0;0,0;0,0;0,0
2020-03-06;Abruzzo;9;0;9;0;9;1;0;0;9;96;;1,0;0,0;0,0;0,0;0,0
2020-03-07;Abruzzo;11;0;11;0;11;2;0;0;11;123;;2,0;27,0;0,0;0,0;0,0
2020-03-08;Abruzzo;14;0;14;3;17;6;0;0;17;163;;6,0;40,0;0,0;0,0;0,0
2020-03-09;Abruzzo;25;0;25;5;30;13;0;0;30;237;;13,0;74,0;0,0;0,0;0,0
2020-03-10;Abruzzo;17;9;26;11;37;7;0;1;38;310;;8,0;73,0;1,0;0,0;9,0
2020-03-11;Abruzzo;17;9;26;11;37;0;0;1;38;310;;0,0;0,0;0,0;0,0;0,0
2020-03-12;Abruzzo;47;12;59;19;78;41;4;2;84;867;;46,0;557,0;1,0;4,0;3,0
2020-03-13;Abruzzo;42;14;56;27;83;5;4;2;89;958;;5,0;91,0;0,0;0,0;2,0
2020-03-14;Abruzzo;51;14;65;41;106;23;4;2;112;1232;;23,0;274,0;0,0;0,0;0,0
2020-03-15;Abruzzo;72;28;100;28;128;22;6;3;137;1419;;25,0;187,0;1,0;2,0;14,0
2020-03-16;Abruzzo;71;37;108;57;165;37;7;4;176;1533;;39,0;114,0;1,0;1,0;9,0
2020-03-17;Abruzzo;94;32;126;90;216;51;7;6;229;1688;;53,0;155,0;2,0;0,0;-5,0
2020-03-18;Abruzzo;99;41;140;109;249;33;7;7;263;2054;;34,0;366,0;1,0;0,0;9,0
2020-03-19;Abruzzo;181;47;228;138;366;117;8;11;385;2409;;122,0;355,0;4,0;1,0;6,0
2020-03-20;Abruzzo;190;48;238;184;422;56;10;17;449;2695;;64,0;286,0;6,0;2,0;1,0
2020-03-21;Abruzzo;185;44;229;265;494;72;13;22;529;3035;;80,0;340,0;5,0;3,0;-4,0
2020-03-22;Abruzzo;218;49;267;272;539;45;15;33;587;3375;;58,0;340,0;11,0;2,0;5,0
2020-03-23;Abruzzo;228;52;280;325;605;66;20;38;663;3674;;76,0;299,0;5,0;5,0;3,0
2020-03-24;Abruzzo;234;57;291;331;622;17;21;46;689;4294;;26,0;620,0;8,0;1,0;5,0
2020-03-25;Abruzzo;248;59;307;431;738;116;23;52;813;4982;;124,0;688,0;6,0;2,0;2,0
2020-03-26;Abruzzo;280;64;344;516;860;122;23;63;946;5488;;133,0;506,0;11,0;0,0;5,0
2020-03-27;Abruzzo;289;71;360;565;925;65;24;68;1017;6109;;71,0;621,0;5,0;1,0;7,0
2020-03-28;Abruzzo;311;70;381;646;1027;102;30;76;1133;7003;;116,0;894,0;8,0;6,0;-1,0
2020-03-29;Abruzzo;329;68;397;772;1169;142;36;88;1293;7730;;160,0;727,0;12,0;6,0;-2,0
2020-03-30;Abruzzo;322;69;391;778;1169;0;74;102;1345;7948;;52,0;218,0;14,0;38,0;1,0
2020-03-31;Abruzzo;335;73;408;783;1191;22;95;115;1401;8758;;56,0;810,0;13,0;21,0;4,0
2020-04-01;Abruzzo;342;71;413;798;1211;20;102;123;1436;9610;;35,0;852,0;8,0;7,0;-2,0
2020-04-02;Abruzzo;341;75;416;835;1251;40;113;133;1497;10647;;61,0;1037,0;10,0;11,0;4,0
2020-04-03;Abruzzo;361;76;437;864;1301;50;116;146;1563;11890;;66,0;1243,0;13,0;3,0;1,0
2020-04-04;Abruzzo;354;71;425;931;1356;55;119;153;1628;12837;;65,0;947,0;7,0;3,0;-5,0
2020-04-05;Abruzzo;347;67;414;1006;1420;64;125;158;1703;13598;;75,0;761,0;5,0;6,0;-4,0
2020-04-06;Abruzzo;340;66;406;1019;1425;5;127;169;1721;14198;;18,0;600,0;11,0;2,0;-1,0
2020-04-07;Abruzzo;337;67;404;1087;1491;66;136;172;1799;14904;;78,0;706,0;3,0;9,0;1,0
2020-04-08;Abruzzo;331;62;393;1141;1534;43;146;179;1859;15846;;60,0;942,0;7,0;10,0;-5,0
2020-04-09;Abruzzo;306;57;363;1203;1566;32;171;194;1931;16847;;72,0;1001,0;15,0;25,0;-5,0
2020-04-10;Abruzzo;305;53;358;1277;1635;69;181;198;2014;18088;;83,0;1241,0;4,0;10,0;-4,0
2020-04-11;Abruzzo;315;54;369;1355;1724;89;190;206;2120;19441;;106,0;1353,0;8,0;9,0;1,0
2020-04-12;Abruzzo;346;54;400;1342;1742;18;206;212;2160;20594;;40,0;1153,0;6,0;16,0;0,0
2020-04-13;Abruzzo;351;54;405;1373;1778;36;211;224;2213;20667;;53,0;73,0;12,0;5,0;0,0
2020-04-14;Abruzzo;345;52;397;1403;1800;22;213;232;2245;20935;;32,0;268,0;8,0;2,0;-2,0
2020-04-15;Abruzzo;341;44;385;1425;1810;10;224;240;2274;22500;;29,0;1565,0;8,0;11,0;-8,0
2020-04-16;Abruzzo;324;42;366;1484;1850;40;253;243;2346;23786;;72,0;1286,0;3,0;29,0;-2,0
2020-04-17;Abruzzo;319;43;362;1580;1942;92;255;246;2443;25436;;97,0;1650,0;3,0;2,0;1,0
2020-04-18;Abruzzo;321;41;362;1609;1971;29;263;253;2487;27016;;44,0;1580,0;7,0;8,0;-2,0
2020-04-19;Abruzzo;317;40;357;1630;1987;16;276;258;2521;27791;22424,0;34,0;775,0;5,0;13,0;-1,0
2020-04-20;Abruzzo;320;38;358;1704;2062;75;287;263;2612;27942;22552,0;91,0;151,0;5,0;11,0;-2,0
2020-04-21;Abruzzo;318;35;353;1714;2067;5;329;271;2667;29906;23901,0;55,0;1964,0;8,0;42,0;-3,0
2020-04-22;Abruzzo;309;35;344;1764;2108;41;349;276;2733;30348;24317,0;66,0;442,0;5,0;20,0;0,0
2020-04-23;Abruzzo;322;31;353;1747;2100;-8;405;280;2785;31187;24751,0;52,0;839,0;4,0;56,0;-4,0
2020-04-24;Abruzzo;327;28;355;1724;2079;-21;438;286;2803;32397;25397,0;18,0;1210,0;6,0;33,0;-3,0
2020-04-25;Abruzzo;323;26;349;1712;2061;-18;478;293;2832;33624;25959,0;29,0;1227,0;7,0;40,0;-2,0
2020-04-26;Abruzzo;324;24;348;1720;2068;7;496;295;2859;33820;26184,0;27,0;196,0;2,0;18,0;-2,0
2020-04-27;Abruzzo;328;23;351;1679;2030;-38;545;299;2874;34176;26443,0;15,0;356,0;4,0;49,0;-1,0
2020-04-28;Abruzzo;312;21;333;1657;1990;-40;599;310;2899;35356;27054,0;25,0;1180,0;11,0;54,0;-2,0
2020-04-29;Abruzzo;309;19;328;1648;1976;-14;632;315;2923;36614;27703,0;24,0;1258,0;5,0;33,0;-2,0
2020-04-30;Abruzzo;306;16;322;1593;1915;-61;695;320;2930;37996;28351,0;7,0;1382,0;5,0;63,0;-3,0
2020-05-01;Abruzzo;297;16;313;1598;1911;-4;713;324;2948;39385;29024,0;18,0;1389,0;4,0;18,0;0,0
2020-05-02;Abruzzo;303;16;319;1560;1879;-32;758;327;2964;39916;29308,0;16,0;531,0;3,0;45,0;0,0
2020-05-03;Abruzzo;300;16;316;1552;1868;-11;798;330;2996;40699;29788,0;32,0;783,0;3,0;40,0;0,0
2020-05-04;Abruzzo;301;15;316;1521;1837;-31;831;332;3000;41108;30047,0;4,0;409,0;2,0;33,0;-1,0
2020-05-05;Abruzzo;289;11;300;1509;1809;-28;881;335;3025;42489;30835,0;25,0;1381,0;3,0;50,0;-4,0
2020-05-06;Abruzzo;285;11;296;1495;1791;-18;915;341;3047;43803;31502,0;22,0;1314,0;6,0;34,0;0,0
2020-05-07;Abruzzo;263;12;275;1495;1770;-21;954;348;3072;45021;32186,0;25,0;1218,0;7,0;39,0;1,0
2020-05-08;Abruzzo;250;10;260;1453;1713;-57;1014;351;3078;46103;32619,0;6,0;1082,0;3,0;60,0;-2,0
2020-05-09;Abruzzo;246;10;256;1420;1676;-37;1055;355;3086;47190;33013,0;8,0;1087,0;4,0;41,0;0,0
2020-05-10;Abruzzo;233;10;243;1428;1671;-5;1073;359;3103;48110;33876,0;17,0;920,0;4,0;18,0;0,0
2020-02-24;Basilicata;0;0;0;0;0;0;0;0;0;0;;0,0;0,0;0,0;0,0;0,0
2020-02-25;Basilicata;0;0;0;0;0;0;0;0;0;0;;0,0;0,0;0,0;0,0;0,0
2020-02-26;Basilicata;0;0;0;0;0;0;0;0;0;0;;0,0;0,0;0,0;0,0;0,0
2020-02-27;Basilicata;0;0;0;0;0;0;0;0;0;0;;0,0;0,0;0,0;0,0;0,0
2020-02-28;Basilicata;0;0;0;0;0;0;0;0;0;0;;0,0;0,0;0,0;0,0;0,0
2020-02-29;Basilicata;0;0;0;0;0;0;0;0;0;32;;0,0;32,0;0,0;0,0;0,0
2020-03-01;Basilicata;0;0;0;0;0;0;0;0;0;39;;0,0;7,0;0,0;0,0;0,0
2020-03-02;Basilicata;0;0;0;0;0;0;0;0;0;39;;0,0;0,0;0,0;0,0;0,0
2020-03-03;Basilicata;0;0;0;1;1;1;0;0;1;42;;1,0;3,0;0,0;0,0;0,0
2020-03-04;Basilicata;0;0;0;1;1;0;0;0;1;48;;0,0;6,0;0,0;0,0;0,0
2020-03-05;Basilicata;0;0;0;1;1;0;0;0;1;54;;0,0;6,0;0,0;0,0;0,0
2020-03-06;Basilicata;1;0;1;2;3;2;0;0;3;63;;2,0;9,0;0,0;0,0;0,0
2020-03-07;Basilicata;1;0;1;2;3;0;0;0;3;75;;0,0;12,0;0,0;0,0;0,0
2020-03-08;Basilicata;2;0;2;2;4;1;0;0;4;123;;1,0;48,0;0,0;0,0;0,0
2020-03-09;Basilicata;2;0;2;3;5;1;0;0;5;135;;1,0;12,0;0,0;0,0;0,0
2020-03-10;Basilicata;2;0;2;5;7;2;0;0;7;148;;2,0;13,0;0,0;0,0;0,0
2020-03-11;Basilicata;1;1;2;6;8;1;0;0;8;155;;1,0;7,0;0,0;0,0;1,0
2020-03-12;Basilicata;1;1;2;6;8;0;0;0;8;155;;0,0;0,0;0,0;0,0;0,0
2020-03-13;Basilicata;1;1;2;8;10;2;0;0;10;155;;2,0;0,0;0,0;0,0;0,0
2020-03-14;Basilicata;0;2;2;8;10;0;0;0;10;155;;0,0;0,0;0,0;0,0;1,0
2020-03-15;Basilicata;0;2;2;9;11;1;0;0;11;208;;1,0;53,0;0,0;0,0;0,0
2020-03-16;Basilicata;1;2;3;9;12;1;0;0;12;230;;1,0;22,0;0,0;0,0;0,0
2020-03-17;Basilicata;5;2;7;13;20;8;0;0;20;262;;8,0;32,0;0,0;0,0;0,0
2020-03-18;Basilicata;9;2;11;16;27;7;0;0;27;262;;7,0;0,0;0,0;0,0;0,0
2020-03-19;Basilicata;8;5;13;24;37;10;0;0;37;353;;10,0;91,0;0,0;0,0;3,0
2020-03-20;Basilicata;8;5;13;39;52;15;0;0;52;443;;15,0;90,0;0,0;0,0;0,0
2020-03-21;Basilicata;12;7;19;47;66;14;0;0;66;522;;14,0;79,0;0,0;0,0;2,0
2020-03-22;Basilicata;13;10;23;58;81;15;0;0;81;643;;15,0;121,0;0,0;0,0;3,0
2020-03-23;Basilicata;15;12;27;62;89;8;0;1;90;696;;9,0;53,0;1,0;0,0;2,0
2020-03-24;Basilicata;14;12;26;65;91;2;0;1;92;744;;2,0;48,0;0,0;0,0;0,0
2020-03-25;Basilicata;20;14;34;78;112;21;0;1;113;857;;21,0;113,0;0,0;0,0;2,0
2020-03-26;Basilicata;22;16;38;95;133;21;0;1;134;1046;;21,0;189,0;0,0;0,0;2,0
2020-03-27;Basilicata;22;15;37;110;147;14;1;3;151;1254;;17,0;208,0;2,0;1,0;-1,0
2020-03-28;Basilicata;26;19;45;133;178;31;1;3;182;1421;;31,0;167,0;0,0;0,0;4,0
2020-03-29;Basilicata;32;18;50;147;197;19;1;4;202;1585;;20,0;164,0;1,0;0,0;-1,0
2020-03-30;Basilicata;36;18;54;154;208;11;1;5;214;1833;;12,0;248,0;1,0;0,0;0,0
2020-03-31;Basilicata;37;17;54;162;216;8;3;7;226;2043;;12,0;210,0;2,0;2,0;-1,0
2020-04-01;Basilicata;39;15;54;171;225;9;3;9;237;2262;;11,0;219,0;2,0;0,0;-2,0
2020-04-02;Basilicata;38;19;57;176;233;8;3;10;246;2427;;9,0;165,0;1,0;0,0;4,0
2020-04-03;Basilicata;41;19;60;187;247;14;3;11;261;2622;;15,0;195,0;1,0;0,0;0,0
2020-04-04;Basilicata;44;19;63;181;244;-3;9;11;264;2765;;3,0;143,0;0,0;6,0;0,0
2020-04-05;Basilicata;46;18;64;190;254;10;11;13;278;2931;;14,0;166,0;2,0;2,0;-1,0
2020-04-06;Basilicata;46;18;64;198;262;8;12;13;287;3061;;9,0;130,0;0,0;1,0;0,0
2020-04-07;Basilicata;47;17;64;201;265;3;12;14;291;3160;;4,0;99,0;1,0;0,0;-1,0
2020-04-08;Basilicata;48;17;65;205;270;5;13;14;297;3296;;6,0;136,0;0,0;1,0;0,0
2020-04-09;Basilicata;50;17;67;208;275;5;13;15;303;3474;;6,0;178,0;1,0;0,0;0,0
2020-04-10;Basilicata;59;15;74;205;279;4;14;15;308;3696;;5,0;222,0;0,0;1,0;-2,0
2020-04-11;Basilicata;60;12;72;209;281;2;14;17;312;4050;;4,0;354,0;2,0;0,0;-3,0
2020-04-12;Basilicata;61;12;73;204;277;-4;20;18;315;4355;;3,0;305,0;1,0;6,0;0,0
2020-04-13;Basilicata;64;12;76;194;270;-7;31;18;319;4545;;4,0;190,0;0,0;11,0;0,0
2020-04-14;Basilicata;62;12;74;191;265;-5;35;19;319;4759;;0,0;214,0;1,0;4,0;0,0
2020-04-15;Basilicata;60;12;72;189;261;-4;38;21;320;5037;;1,0;278,0;2,0;3,0;0,0
2020-04-16;Basilicata;60;9;69;204;273;12;41;22;336;5349;;16,0;312,0;1,0;3,0;-3,0
2020-04-17;Basilicata;59;9;68;198;266;-7;49;22;337;5710;;1,0;361,0;0,0;8,0;0,0
2020-04-18;Basilicata;60;8;68;194;262;-4;54;23;339;6056;;2,0;346,0;1,0;5,0;-1,0
2020-04-19;Basilicata;59;8;67;180;247;-15;71;24;342;6528;6528,0;3,0;472,0;1,0;17,0;0,0
2020-04-20;Basilicata;59;7;66;176;242;-5;76;24;342;6868;6868,0;0,0;340,0;0,0;5,0;-1,0
2020-04-21;Basilicata;64;7;71;174;245;3;81;24;350;7470;7470,0;8,0;602,0;0,0;5,0;0,0
2020-04-22;Basilicata;65;7;72;160;232;-13;98;24;354;8040;8040,0;4,0;570,0;0,0;17,0;0,0
2020-04-23;Basilicata;61;7;68;161;229;-3;103;24;356;8511;8511,0;2,0;471,0;0,0;5,0;0,0
2020-04-24;Basilicata;59;7;66;163;229;0;107;24;360;9026;9026,0;4,0;515,0;0,0;4,0;0,0
2020-04-25;Basilicata;58;7;65;153;218;-11;118;25;361;9792;9792,0;1,0;766,0;1,0;11,0;0,0
2020-04-26;Basilicata;57;7;64;155;219;1;122;25;366;10077;10077,0;5,0;285,0;0,0;4,0;0,0
2020-04-27;Basilicata;57;7;64;153;217;-2;124;25;366;10364;10364,0;0,0;287,0;0,0;2,0;0,0
2020-04-28;Basilicata;56;7;63;142;205;-12;136;25;366;10889;10889,0;0,0;525,0;0,0;12,0;0,0
2020-04-29;Basilicata;51;4;55;139;194;-11;147;25;366;11331;11331,0;0,0;442,0;0,0;11,0;-3,0
2020-04-30;Basilicata;49;4;53;139;192;-2;150;25;367;12774;12774,0;1,0;1443,0;0,0;3,0;0,0
2020-05-01;Basilicata;49;4;53;140;193;1;160;25;378;13269;13269,0;11,0;495,0;0,0;10,0;0,0
2020-05-02;Basilicata;48;4;52;139;191;-2;164;25;380;13722;13722,0;2,0;453,0;0,0;4,0;0,0
2020-05-03;Basilicata;48;3;51;143;194;3;167;25;386;14210;14210,0;6,0;488,0;0,0;3,0;-1,0
2020-05-04;Basilicata;50;3;53;120;173;-21;188;25;386;14901;14455,0;0,0;691,0;0,0;21,0;0,0
2020-05-05;Basilicata;50;3;53;124;177;4;194;25;396;15476;15028,0;10,0;575,0;0,0;6,0;0,0
2020-05-06;Basilicata;47;3;50;122;172;-5;202;25;399;16103;15619,0;3,0;627,0;0,0;8,0;0,0
2020-05-07;Basilicata;48;2;50;105;155;-17;202;26;383;16272;15780,0;-16,0;169,0;1,0;0,0;-1,0
2020-05-08;Basilicata;48;2;50;102;152;-3;204;26;382;16777;16285,0;-1,0;505,0;0,0;2,0;0,0
2020-05-09;Basilicata;45;1;46;99;145;-7;210;27;382;17433;16941,0;0,0;656,0;1,0;6,0;-1,0
2020-05-10;Basilicata;45;1;46;97;143;-2;215;27;385;17916;17424,0;3,0;483,0;0,0;5,0;0,0
2020-02-24;Calabria;0;0;0;0;0;0;0;0;0;1;;0,0;1,0;0,0;0,0;0,0
2020-02-25;Calabria;0;0;0;0;0;0;0;0;0;2;;0,0;1,0;0,0;0,0;0,0
2020-02-26;Calabria;0;0;0;0;0;0;0;0;0;3;;0,0;1,0;0,0;0,0;0,0
2020-02-27;Calabria;0;0;0;0;0;0;0;0;0;14;;0,0;11,0;0,0;0,0;0,0
2020-02-28;Calabria;0;0;0;1;1;1;0;0;1;21;;1,0;7,0;0,0;0,0;0,0
2020-02-29;Calabria;0;0;0;1;1;0;0;0;1;27;;0,0;6,0;0,0;0,0;0,0
2020-03-01;Calabria;0;0;0;1;1;0;0;0;1;35;;0,0;8,0;0,0;0,0;0,0
2020-03-02;Calabria;0;0;0;1;1;0;0;0;1;39;;0,0;4,0;0,0;0,0;0,0
2020-03-03;Calabria;0;0;0;1;1;0;0;0;1;39;;0,0;0,0;0,0;0,0;0,0
2020-03-04;Calabria;0;0;0;1;1;0;0;0;1;46;;0,0;7,0;0,0;0,0;0,0
2020-03-05;Calabria;1;0;1;1;2;1;0;0;2;53;;1,0;7,0;0,0;0,0;0,0
2020-03-06;Calabria;2;0;2;2;4;2;0;0;4;99;;2,0;46,0;0,0;0,0;0,0
2020-03-07;Calabria;2;0;2;2;4;0;0;0;4;113;;0,0;14,0;0,0;0,0;0,0
2020-03-08;Calabria;5;0;5;4;9;5;0;0;9;113;;5,0;0,0;0,0;0,0;0,0
2020-03-09;Calabria;8;0;8;1;9;0;2;0;11;173;;2,0;60,0;0,0;2,0;0,0
2020-03-10;Calabria;8;2;10;1;11;2;2;0;13;360;;2,0;187,0;0,0;0,0;2,0
2020-03-11;Calabria;10;2;12;5;17;6;2;0;19;405;;6,0;45,0;0,0;0,0;0,0
2020-03-12;Calabria;14;2;16;16;32;15;1;0;33;483;;14,0;78,0;0,0;-1,0;0,0
2020-03-13;Calabria;18;3;21;16;37;5;1;0;38;504;;5,0;21,0;0,0;0,0;1,0
2020-03-14;Calabria;22;4;26;33;59;22;1;0;60;711;;22,0;207,0;0,0;0,0;1,0
2020-03-15;Calabria;32;6;38;28;66;7;1;1;68;884;;8,0;173,0;1,0;0,0;2,0
2020-03-16;Calabria;36;7;43;44;87;21;1;1;89;1030;;21,0;146,0;0,0;0,0;1,0
2020-03-17;Calabria;45;10;55;57;112;25;1;1;114;1293;;25,0;263,0;0,0;0,0;3,0
2020-03-18;Calabria;45;11;56;70;126;14;2;1;129;1668;;15,0;375,0;0,0;1,0;1,0
2020-03-19;Calabria;60;13;73;91;164;38;2;3;169;2342;;40,0;674,0;2,0;0,0;2,0
2020-03-20;Calabria;71;16;87;114;201;37;2;4;207;2690;;38,0;348,0;1,0;0,0;3,0
2020-03-21;Calabria;73;16;89;136;225;24;5;5;235;3050;;28,0;360,0;1,0;3,0;0,0
2020-03-22;Calabria;77;17;94;166;260;35;5;8;273;3666;;38,0;616,0;3,0;0,0;1,0
2020-03-23;Calabria;82;20;102;178;280;20;5;7;292;4073;;19,0;407,0;-1,0;0,0;3,0
2020-03-24;Calabria;88;21;109;195;304;24;5;10;319;4486;;27,0;413,0;3,0;0,0;1,0
2020-03-25;Calabria;93;23;116;217;333;29;7;11;351;5058;;32,0;572,0;1,0;2,0;2,0
2020-03-26;Calabria;101;23;124;248;372;39;7;14;393;5933;;42,0;875,0;3,0;0,0;0,0
2020-03-27;Calabria;103;22;125;344;469;97;7;18;494;6901;;101,0;968,0;4,0;0,0;-1,0
2020-03-28;Calabria;107;22;129;394;523;54;11;21;555;7760;;61,0;859,0;3,0;4,0;0,0
2020-03-29;Calabria;124;19;143;434;577;54;12;25;614;8485;;59,0;725,0;4,0;1,0;-3,0
2020-03-30;Calabria;130;18;148;454;602;25;14;31;647;9013;;33,0;528,0;6,0;2,0;-1,0
2020-03-31;Calabria;132;17;149;457;606;4;17;36;659;9327;;12,0;314,0;5,0;3,0;-1,0
2020-04-01;Calabria;144;16;160;450;610;4;21;38;669;9983;;10,0;656,0;2,0;4,0;-1,0
2020-04-02;Calabria;163;19;182;445;627;17;23;41;691;10679;;22,0;696,0;3,0;2,0;3,0
2020-04-03;Calabria;183;17;200;462;662;35;26;45;733;11608;;42,0;929,0;4,0;3,0;-2,0
2020-04-04;Calabria;178;15;193;469;662;0;30;49;741;12314;;8,0;706,0;4,0;4,0;-2,0
2020-04-05;Calabria;174;13;187;519;706;44;33;56;795;13077;;54,0;763,0;7,0;3,0;-2,0
2020-04-06;Calabria;170;14;184;538;722;16;37;58;817;13633;;22,0;556,0;2,0;4,0;1,0
2020-04-07;Calabria;169;14;183;550;733;11;40;60;833;14072;;16,0;439,0;2,0;3,0;0,0
2020-04-08;Calabria;170;15;185;570;755;22;44;60;859;14977;;26,0;905,0;0,0;4,0;1,0
2020-04-09;Calabria;168;15;183;582;765;10;48;61;874;15698;;15,0;721,0;1,0;4,0;0,0
2020-04-10;Calabria;168;14;182;604;786;21;50;65;901;16637;;27,0;939,0;4,0;2,0;-1,0
2020-04-11;Calabria;169;15;184;608;792;6;57;66;915;17493;;14,0;856,0;1,0;7,0;1,0
2020-04-12;Calabria;165;14;179;616;795;3;62;66;923;18211;;8,0;718,0;0,0;5,0;-1,0
2020-04-13;Calabria;160;12;172;619;791;-4;70;67;928;18596;;5,0;385,0;1,0;8,0;-2,0
2020-04-14;Calabria;161;12;173;643;816;25;72;68;956;19014;;28,0;418,0;1,0;2,0;0,0
2020-04-15;Calabria;156;11;167;652;819;3;81;71;971;19662;;15,0;648,0;3,0;9,0;-1,0
2020-04-16;Calabria;157;9;166;681;847;28;90;72;1009;20642;;38,0;980,0;1,0;9,0;-2,0
2020-04-17;Calabria;154;7;161;658;819;-28;99;73;991;21657;;-18,0;1015,0;1,0;9,0;-2,0
2020-04-18;Calabria;152;7;159;673;832;13;106;73;1011;22794;;20,0;1137,0;0,0;7,0;0,0
2020-04-19;Calabria;142;6;148;696;844;12;116;75;1035;23760;22234,0;24,0;966,0;2,0;10,0;-1,0
2020-04-20;Calabria;140;7;147;681;828;-16;135;75;1038;24373;22847,0;3,0;613,0;0,0;19,0;1,0
2020-04-21;Calabria;133;7;140;679;819;-9;152;76;1047;25440;23914,0;9,0;1067,0;1,0;17,0;0,0
2020-04-22;Calabria;128;7;135;686;821;2;163;76;1060;26560;24878,0;13,0;1120,0;0,0;11,0;0,0
2020-04-23;Calabria;129;7;136;687;823;2;170;76;1069;27869;26187,0;9,0;1309,0;0,0;7,0;0,0
2020-04-24;Calabria;123;7;130;691;821;-2;178;80;1079;28764;26811,0;10,0;895,0;4,0;8,0;0,0
2020-04-25;Calabria;125;7;132;679;811;-10;197;80;1088;29959;28006,0;9,0;1195,0;0,0;19,0;0,0
2020-04-26;Calabria;118;8;126;671;797;-14;212;80;1089;30853;28900,0;1,0;894,0;0,0;15,0;1,0
2020-04-27;Calabria;114;6;120;662;782;-15;231;83;1096;31787;29834,0;7,0;934,0;3,0;19,0;-2,0
2020-04-28;Calabria;113;6;119;645;764;-18;248;85;1097;33755;31802,0;1,0;1968,0;2,0;17,0;0,0
2020-04-29;Calabria;107;6;113;640;753;-11;263;86;1102;34914;32961,0;5,0;1159,0;1,0;15,0;0,0
2020-04-30;Calabria;105;6;111;629;740;-13;282;86;1108;35903;33950,0;6,0;989,0;0,0;19,0;0,0
2020-05-01;Calabria;105;3;108;619;727;-13;299;86;1112;37054;35101,0;4,0;1151,0;0,0;17,0;-3,0
2020-05-02;Calabria;100;4;104;609;713;-14;311;88;1112;37928;35975,0;0,0;874,0;2,0;12,0;1,0
2020-05-03;Calabria;95;4;99;603;702;-11;324;88;1114;38835;36874,0;2,0;907,0;0,0;13,0;0,0
2020-05-04;Calabria;93;4;97;577;674;-28;356;88;1118;39438;37390,0;4,0;603,0;0,0;32,0;0,0
2020-05-05;Calabria;92;4;96;554;650;-24;381;88;1119;40509;38461,0;1,0;1071,0;0,0;25,0;0,0
2020-05-06;Calabria;87;3;90;554;644;-6;389;89;1122;41828;39780,0;3,0;1319,0;1,0;8,0;-1,0
2020-05-07;Calabria;81;2;83;550;633;-11;403;89;1125;42854;40806,0;3,0;1026,0;0,0;14,0;-1,0
2020-05-08;Calabria;73;2;75;544;619;-14;417;90;1126;43980;41902,0;1,0;1126,0;1,0;14,0;0,0
2020-05-09;Calabria;68;2;70;542;612;-7;427;90;1129;45071;42993,0;3,0;1091,0;0,0;10,0;0,0
2020-05-10;Calabria;66;2;68;528;596;-16;445;91;1132;46111;44284,0;3,0;1040,0;1,0;18,0;0,0
2020-02-24;Campania;0;0;0;0;0;0;0;0;0;10;;0,0;10,0;0,0;0,0;0,0
2020-02-25;Campania;0;0;0;0;0;0;0;0;0;10;;0,0;0,0;0,0;0,0;0,0
2020-02-26;Campania;0;0;0;0;0;0;0;0;0;10;;0,0;0,0;0,0;0,0;0,0
2020-02-27;Campania;2;0;2;1;3;3;0;0;3;10;;3,0;0,0;0,0;0,0;0,0
2020-02-28;Campania;2;0;2;2;4;1;0;0;4;213;;1,0;203,0;0,0;0,0;0,0
2020-02-29;Campania;3;0;3;10;13;9;0;0;13;373;;9,0;160,0;0,0;0,0;0,0
2020-03-01;Campania;4;0;4;13;17;4;0;0;17;373;;4,0;0,0;0,0;0,0;0,0
2020-03-02;Campania;4;0;4;13;17;0;0;0;17;373;;0,0;0,0;0,0;0,0;0,0
2020-03-03;Campania;11;0;11;19;30;13;0;0;30;405;;13,0;32,0;0,0;0,0;0,0
2020-03-04;Campania;11;0;11;20;31;1;0;0;31;429;;1,0;24,0;0,0;0,0;0,0
2020-03-05;Campania;12;0;12;33;45;14;0;0;45;471;;14,0;42,0;0,0;0,0;0,0
2020-03-06;Campania;12;0;12;45;57;12;0;0;57;471;;12,0;0,0;0,0;0,0;0,0
2020-03-07;Campania;16;0;16;45;61;4;0;0;61;612;;4,0;141,0;0,0;0,0;0,0
2020-03-08;Campania;30;7;37;63;100;39;1;0;101;980;;40,0;368,0;0,0;1,0;7,0
2020-03-09;Campania;42;8;50;69;119;19;1;0;120;980;;19,0;0,0;0,0;0,0;1,0
2020-03-10;Campania;33;8;41;85;126;7;1;0;127;1141;;7,0;161,0;0,0;0,0;0,0
2020-03-11;Campania;56;11;67;82;149;23;4;1;154;1375;;27,0;234,0;1,0;3,0;3,0
2020-03-12;Campania;56;11;67;107;174;25;4;1;179;1551;;25,0;176,0;0,0;0,0;0,0
2020-03-13;Campania;60;19;79;134;213;39;5;2;220;1671;;41,0;120,0;1,0;1,0;8,0
2020-03-14;Campania;72;17;89;154;243;30;23;6;272;1936;;52,0;265,0;4,0;18,0;-2,0
2020-03-15;Campania;73;22;95;201;296;53;28;9;333;2213;;61,0;277,0;3,0;5,0;5,0
2020-03-16;Campania;103;22;125;238;363;67;28;9;400;2517;;67,0;304,0;0,0;0,0;0,0
2020-03-17;Campania;127;24;151;272;423;60;28;9;460;2685;;60,0;168,0;0,0;0,0;2,0
2020-03-18;Campania;127;24;151;272;423;0;28;9;460;2685;;0,0;0,0;0,0;0,0;0,0
2020-03-19;Campania;213;36;249;356;605;182;30;17;652;3544;;192,0;859,0;8,0;2,0;12,0
2020-03-20;Campania;130;41;171;531;702;97;30;17;749;3845;;97,0;301,0;0,0;0,0;5,0
2020-03-21;Campania;233;87;320;473;793;91;29;22;844;4448;;95,0;603,0;5,0;-1,0;46,0
2020-03-22;Campania;243;99;342;524;866;73;41;29;936;4943;;92,0;495,0;7,0;12,0;12,0
2020-03-23;Campania;266;110;376;553;929;63;48;49;1026;5813;;90,0;870,0;20,0;7,0;11,0
2020-03-24;Campania;345;181;526;466;992;63;53;56;1101;6297;;75,0;484,0;7,0;5,0;71,0
2020-03-25;Campania;318;123;441;631;1072;80;53;74;1199;6972;;98,0;675,0;18,0;0,0;-58,0
2020-03-26;Campania;448;114;562;607;1169;97;58;83;1310;8346;;111,0;1374,0;9,0;5,0;-9,0
2020-03-27;Campania;456;113;569;723;1292;123;64;98;1454;9613;;144,0;1267,0;15,0;6,0;-1,0
2020-03-28;Campania;463;132;595;812;1407;115;76;109;1592;10616;;138,0;1003,0;11,0;12,0;19,0
2020-03-29;Campania;476;135;611;945;1556;149;86;117;1759;11805;;167,0;1189,0;8,0;10,0;3,0
2020-03-30;Campania;468;126;594;1145;1739;183;88;125;1952;12969;;193,0;1164,0;8,0;2,0;-9,0
2020-03-31;Campania;501;133;634;1237;1871;132;88;133;2092;14403;;140,0;1434,0;8,0;0,0;7,0
2020-04-01;Campania;478;129;607;1369;1976;105;107;148;2231;15728;;139,0;1325,0;15,0;19,0;-4,0
2020-04-02;Campania;503;120;623;1517;2140;164;149;167;2456;17404;;225,0;1676,0;19,0;42,0;-9,0
2020-04-03;Campania;532;115;647;1705;2352;212;144;181;2677;19237;;221,0;1833,0;14,0;-5,0;-5,0
2020-04-04;Campania;567;114;681;1815;2496;144;146;186;2828;21534;;151,0;2297,0;5,0;2,0;-1,0
2020-04-05;Campania;609;108;717;1904;2621;125;150;189;2960;23139;;132,0;1605,0;3,0;4,0;-6,0
2020-04-06;Campania;610;101;711;1987;2698;77;156;204;3058;24526;;98,0;1387,0;15,0;6,0;-7,0
2020-04-07;Campania;603;103;706;2059;2765;67;167;216;3148;25779;;90,0;1253,0;12,0;11,0;2,0
2020-04-08;Campania;608;97;705;2154;2859;94;188;221;3268;27784;;120,0;2005,0;5,0;21,0;-6,0
2020-04-09;Campania;604;94;698;2175;2873;14;244;227;3344;29664;;76,0;1880,0;6,0;56,0;-3,0
2020-04-10;Campania;600;90;690;2273;2963;90;248;231;3442;31745;;98,0;2081,0;4,0;4,0;-4,0
2020-04-11;Campania;582;85;667;2335;3002;39;277;238;3517;33781;;75,0;2036,0;7,0;29,0;-5,0
2020-04-12;Campania;526;82;608;2449;3057;55;305;242;3604;35448;;87,0;1667,0;4,0;28,0;-3,0
2020-04-13;Campania;606;80;686;2376;3062;5;360;248;3670;36770;;66,0;1322,0;6,0;55,0;-2,0
2020-04-14;Campania;618;82;700;2394;3094;32;415;260;3769;38094;;99,0;1324,0;12,0;55,0;2,0
2020-04-15;Campania;607;86;693;2394;3087;-7;442;278;3807;39534;;38,0;1440,0;18,0;27,0;4,0
2020-04-16;Campania;618;76;694;2424;3118;31;483;286;3887;41296;;80,0;1762,0;8,0;41,0;-10,0
2020-04-17;Campania;622;76;698;2329;3027;-91;631;293;3951;43697;;64,0;2401,0;7,0;148,0;0,0
2020-04-18;Campania;605;76;681;2364;3045;18;643;300;3988;46294;;37,0;2597,0;7,0;12,0;0,0
2020-04-19;Campania;590;61;651;2371;3022;-23;703;304;4029;48187;34994,0;41,0;1893,0;4,0;60,0;-15,0
2020-04-20;Campania;586;61;647;2372;3019;-3;746;309;4074;51090;36153,0;45,0;2903,0;5,0;43,0;0,0
2020-04-21;Campania;532;58;590;2356;2946;-73;872;317;4135;53548;37505,0;61,0;2458,0;8,0;126,0;-3,0
2020-04-22;Campania;523;53;576;2422;2998;52;860;327;4185;55701;38679,0;50,0;2153,0;10,0;-12,0;-5,0
2020-04-23;Campania;539;47;586;2392;2978;-20;928;332;4238;58324;38679,0;53,0;2623,0;5,0;68,0;-6,0
2020-04-24;Campania;524;44;568;2375;2943;-35;1003;336;4282;61331;40053,0;44,0;3007,0;4,0;75,0;-3,0
2020-04-25;Campania;543;55;598;2337;2935;-8;1023;341;4299;64521;41399,0;17,0;3190,0;5,0;20,0;11,0
2020-04-26;Campania;536;45;581;2343;2924;-11;1062;345;4331;67218;42279,0;32,0;2697,0;4,0;39,0;-10,0
2020-04-27;Campania;541;37;578;2299;2877;-47;1120;352;4349;68727;42463,0;18,0;1509,0;7,0;58,0;-8,0
2020-04-28;Campania;544;33;577;2225;2802;-75;1220;358;4380;70566;42690,0;31,0;1839,0;6,0;100,0;-4,0
2020-04-29;Campania;518;31;549;2233;2782;-20;1269;359;4410;73094;43449,0;30,0;2528,0;1,0;49,0;-2,0
2020-04-30;Campania;484;29;513;2260;2773;-9;1291;359;4423;76108;44233,0;13,0;3014,0;0,0;22,0;-2,0
2020-05-01;Campania;478;29;507;2246;2753;-20;1332;359;4444;79940;44975,0;21,0;3832,0;0,0;41,0;0,0
2020-05-02;Campania;470;27;497;2224;2721;-32;1376;362;4459;83592;45955,0;15,0;3652,0;3,0;44,0;-2,0
2020-05-03;Campania;455;30;485;2241;2726;5;1394;364;4484;86498;47027,0;25,0;2906,0;2,0;18,0;3,0
2020-05-04;Campania;438;24;462;2249;2711;-15;1421;366;4498;90543;48275,0;14,0;4045,0;2,0;27,0;-6,0
2020-05-05;Campania;408;25;433;2097;2530;-181;1619;369;4518;93068;48733,0;20,0;2525,0;3,0;198,0;1,0
2020-05-06;Campania;433;25;458;1882;2340;-190;1816;376;4532;96548;49478,0;14,0;3480,0;7,0;197,0;0,0
2020-05-07;Campania;415;27;442;1697;2139;-201;2023;379;4541;101025;50463,0;9,0;4477,0;3,0;207,0;2,0
2020-05-08;Campania;418;28;446;1566;2012;-127;2164;386;4562;105399;51402,0;21,0;4374,0;7,0;141,0;1,0
2020-05-09;Campania;415;26;441;1524;1965;-47;2223;388;4576;110811;52593,0;14,0;5412,0;2,0;59,0;-2,0
2020-05-10;Campania;435;20;455;1460;1915;-50;2282;391;4588;114819;53475,0;12,0;4008,0;3,0;59,0;-6,0
2020-02-24;Emilia-Romagna;10;2;12;6;18;0;0;0;18;148;;18,0;148,0;0,0;0,0;2,0
2020-02-25;Emilia-Romagna;15;2;17;9;26;8;0;0;26;391;;8,0;243,0;0,0;0,0;0,0
2020-02-26;Emilia-Romagna;20;3;23;23;46;20;0;1;47;577;;21,0;186,0;1,0;0,0;1,0
2020-02-27;Emilia-Romagna;36;6;42;54;96;50;0;1;97;1033;;50,0;456,0;0,0;0,0;3,0
2020-02-28;Emilia-Romagna;56;6;62;81;143;47;0;2;145;1277;;48,0;244,0;1,0;0,0;0,0
2020-02-29;Emilia-Romagna;86;11;97;116;213;70;0;4;217;1550;;72,0;273,0;2,0;0,0;5,0
2020-03-01;Emilia-Romagna;127;13;140;137;277;64;0;8;285;1795;;68,0;245,0;4,0;0,0;2,0
2020-03-02;Emilia-Romagna;148;16;164;160;324;47;0;11;335;1973;;50,0;178,0;3,0;0,0;3,0
2020-03-03;Emilia-Romagna;187;24;211;187;398;74;4;18;420;2012;;85,0;39,0;7,0;4,0;8,0
2020-03-04;Emilia-Romagna;256;26;282;234;516;118;6;22;544;2500;;124,0;488,0;4,0;2,0;2,0
2020-03-05;Emilia-Romagna;327;32;359;299;658;142;10;30;698;2884;;154,0;384,0;8,0;4,0;6,0
2020-03-06;Emilia-Romagna;397;53;450;366;816;158;17;37;870;3136;;172,0;252,0;7,0;7,0;21,0
2020-03-07;Emilia-Romagna;464;64;528;409;937;121;25;48;1010;3604;;140,0;468,0;11,0;8,0;11,0
2020-03-08;Emilia-Romagna;542;75;617;480;1097;160;27;56;1180;4344;;170,0;740,0;8,0;2,0;11,0
2020-03-09;Emilia-Romagna;576;90;666;620;1286;189;30;70;1386;4906;;206,0;562,0;14,0;3,0;15,0
2020-03-10;Emilia-Romagna;669;98;767;650;1417;131;31;85;1533;5494;;147,0;588,0;15,0;1,0;8,0
2020-03-11;Emilia-Romagna;745;104;849;739;1588;171;38;113;1739;6640;;206,0;1146,0;28,0;7,0;6,0
2020-03-12;Emilia-Romagna;814;112;926;832;1758;170;43;146;1947;7600;;208,0;960,0;33,0;5,0;8,0
2020-03-13;Emilia-Romagna;942;128;1070;941;2011;253;51;201;2263;8787;;316,0;1187,0;55,0;8,0;16,0
2020-03-14;Emilia-Romagna;1076;152;1228;1121;2349;338;54;241;2644;10043;;381,0;1256,0;40,0;3,0;24,0
2020-03-15;Emilia-Romagna;1215;169;1384;1357;2741;392;68;284;3093;12054;;449,0;2011,0;43,0;14,0;17,0
2020-03-16;Emilia-Romagna;1362;197;1559;1529;3088;347;88;346;3522;13096;;429,0;1042,0;62,0;20,0;28,0
2020-03-17;Emilia-Romagna;1566;223;1789;1615;3404;316;134;393;3931;14510;;409,0;1414,0;47,0;46,0;26,0
2020-03-18;Emilia-Romagna;1784;247;2031;1884;3915;511;152;458;4525;15461;;594,0;951,0;65,0;18,0;24,0
2020-03-19;Emilia-Romagna;1900;260;2160;2346;4506;591;177;531;5214;18344;;689,0;2883,0;73,0;25,0;13,0
2020-03-20;Emilia-Romagna;2083;267;2350;2739;5089;583;239;640;5968;20753;;754,0;2409,0;109,0;62,0;7,0
2020-03-21;Emilia-Romagna;2267;265;2532;3129;5661;572;329;715;6705;24620;;737,0;3867,0;75,0;90,0;-2,0
2020-03-22;Emilia-Romagna;2429;269;2698;3692;6390;729;349;816;7555;28022;;850,0;3402,0;101,0;20,0;4,0
2020-03-23;Emilia-Romagna;2846;276;3122;4098;7220;830;423;892;8535;31200;;980,0;3178,0;76,0;74,0;7,0
2020-03-24;Emilia-Romagna;2974;291;3265;4446;7711;491;558;985;9254;33527;;719,0;2327,0;93,0;135,0;15,0
2020-03-25;Emilia-Romagna;3180;294;3474;4782;8256;545;721;1077;10054;38045;;800,0;4518,0;92,0;163,0;3,0
2020-03-26;Emilia-Romagna;3354;301;3655;5195;8850;594;792;1174;10816;42395;;762,0;4350,0;97,0;71,0;7,0
2020-03-27;Emilia-Romagna;3461;308;3769;5592;9361;511;960;1267;11588;47798;;772,0;5403,0;93,0;168,0;7,0
2020-03-28;Emilia-Romagna;3695;316;4011;5953;9964;603;1075;1344;12383;52991;;795,0;5193,0;77,0;115,0;8,0
2020-03-29;Emilia-Romagna;3769;333;4102;6433;10535;571;1141;1443;13119;52991;;736,0;0,0;99,0;66,0;17,0
2020-03-30;Emilia-Romagna;3779;351;4130;6636;10766;231;1227;1538;13531;50990;;412,0;-2001,0;95,0;86,0;18,0
2020-03-31;Emilia-Romagna;3765;353;4118;6835;10953;187;1477;1644;14074;54532;;543,0;3542,0;106,0;250,0;2,0
2020-04-01;Emilia-Romagna;3898;359;4257;7232;11489;536;1566;1732;14787;58457;;713,0;3925,0;88,0;89,0;6,0
2020-04-02;Emilia-Romagna;3944;366;4310;7549;11859;370;1663;1811;15333;60507;;546,0;2050,0;79,0;97,0;7,0
2020-04-03;Emilia-Romagna;3915;364;4279;7899;12178;319;1852;1902;15932;63682;;599,0;3175,0;91,0;189,0;-2,0
2020-04-04;Emilia-Romagna;3859;358;4217;8306;12523;345;2040;1977;16540;67075;;608,0;3393,0;75,0;188,0;-6,0
2020-04-05;Emilia-Romagna;3839;375;4214;8623;12837;314;2201;2051;17089;69986;;549,0;2911,0;74,0;161,0;17,0
2020-04-06;Emilia-Romagna;3804;372;4176;8875;13051;214;2397;2108;17556;72163;;467,0;2177,0;57,0;196,0;-3,0
2020-04-07;Emilia-Romagna;3750;366;4116;8932;13048;-3;2597;2180;17825;75191;;269,0;3028,0;72,0;200,0;-6,0
2020-04-08;Emilia-Romagna;3769;361;4130;8980;13110;62;2890;2234;18234;78367;;409,0;3176,0;54,0;293,0;-5,0
2020-04-09;Emilia-Romagna;3722;355;4077;9181;13258;148;3103;2316;18677;81715;;443,0;3348,0;82,0;213,0;-6,0
2020-04-10;Emilia-Romagna;3596;349;3945;9405;13350;92;3381;2397;19128;85884;;451,0;4169,0;81,0;278,0;-6,0
2020-04-11;Emilia-Romagna;3530;341;3871;9624;13495;145;3659;2481;19635;91759;;507,0;5875,0;84,0;278,0;-8,0
2020-04-12;Emilia-Romagna;3491;335;3826;9846;13672;177;3862;2564;20098;96704;;463,0;4945,0;83,0;203,0;-6,0
2020-04-13;Emilia-Romagna;3490;331;3821;9997;13818;146;4007;2615;20440;99047;;342,0;2343,0;51,0;145,0;-4,0
2020-04-14;Emilia-Romagna;3473;328;3801;9977;13778;-40;4269;2705;20752;101896;;312,0;2849,0;90,0;262,0;-3,0
2020-04-15;Emilia-Romagna;3388;325;3713;9864;13577;-201;4664;2788;21029;106149;;277,0;4253,0;83,0;395,0;-3,0
2020-04-16;Emilia-Romagna;3360;316;3676;9987;13663;86;4980;2843;21486;112105;;457,0;5956,0;55,0;316,0;-9,0
2020-04-17;Emilia-Romagna;3330;309;3639;9946;13585;-78;5346;2903;21834;116826;;348,0;4721,0;60,0;366,0;-7,0
2020-04-18;Emilia-Romagna;3234;296;3530;10054;13584;-1;5635;2965;22184;121220;;350,0;4394,0;62,0;289,0;-13,0
2020-04-19;Emilia-Romagna;3166;289;3455;10097;13552;-32;5985;3023;22560;124916;88776,0;376,0;3696,0;58,0;350,0;-7,0
2020-04-20;Emilia-Romagna;3144;283;3427;10095;13522;-30;6266;3079;22867;129530;90894,0;307,0;4614,0;56,0;281,0;-6,0
2020-04-21;Emilia-Romagna;3045;282;3327;9917;13244;-278;6701;3147;23092;134878;93367,0;225,0;5348,0;68,0;435,0;-1,0
2020-04-22;Emilia-Romagna;2964;282;3246;9838;13084;-160;7146;3204;23434;140874;96824,0;342,0;5996,0;57,0;445,0;0,0
2020-04-23;Emilia-Romagna;2889;266;3155;9690;12845;-239;7609;3269;23723;146146;99714,0;289,0;5272,0;65,0;463,0;-16,0
2020-04-24;Emilia-Romagna;2807;264;3071;9438;12509;-336;8158;3303;23970;151505;102495,0;247,0;5359,0;34,0;549,0;-2,0
2020-04-25;Emilia-Romagna;2718;246;2964;9383;12347;-162;8515;3347;24209;156883;105628,0;239,0;5378,0;44,0;357,0;-18,0
2020-04-26;Emilia-Romagna;2695;245;2940;9401;12341;-6;8723;3386;24450;161928;109192,0;241,0;5045,0;39,0;208,0;-1,0
2020-04-27;Emilia-Romagna;2640;247;2887;9338;12225;-116;9006;3431;24662;164979;111041,0;212,0;3051,0;45,0;283,0;2,0
2020-04-28;Emilia-Romagna;2574;228;2802;9201;12003;-222;9439;3472;24914;172589;116624,0;252,0;7610,0;41,0;433,0;-19,0
2020-04-29;Emilia-Romagna;2527;226;2753;9109;11862;-141;9803;3512;25177;176865;118881,0;263,0;4276,0;40,0;364,0;-2,0
2020-04-30;Emilia-Romagna;2146;206;2352;7211;9563;-2299;12322;3551;25436;182857;122430,0;259,0;5992,0;39,0;2519,0;-20,0
2020-05-01;Emilia-Romagna;2112;197;2309;7175;9484;-79;12581;3579;25644;188264;125636,0;208,0;5407,0;28,0;259,0;-9,0
2020-05-02;Emilia-Romagna;2033;196;2229;7094;9323;-161;12913;3614;25850;192135;128005,0;206,0;3871,0;35,0;332,0;-1,0
2020-05-03;Emilia-Romagna;1997;197;2194;6851;9045;-278;13329;3642;26016;197075;131047,0;166,0;4940,0;28,0;416,0;1,0
2020-05-04;Emilia-Romagna;1968;199;2167;6817;8984;-61;13525;3666;26175;200427;133329,0;159,0;3352,0;24,0;196,0;2,0
2020-05-05;Emilia-Romagna;1917;191;2108;6573;8681;-303;13889;3705;26275;206166;136310,0;100,0;5739,0;39,0;364,0;-8,0
2020-05-06;Emilia-Romagna;1816;176;1992;6399;8391;-290;14251;3737;26379;211652;138871,0;104,0;5486,0;32,0;362,0;-15,0
2020-05-07;Emilia-Romagna;1726;173;1899;6112;8011;-380;14710;3766;26487;217039;141468,0;108,0;5387,0;29,0;459,0;-3,0
2020-05-08;Emilia-Romagna;1680;163;1843;5887;7730;-281;15071;3797;26598;221866;144009,0;111,0;4827,0;31,0;361,0;-10,0
2020-05-09;Emilia-Romagna;1604;155;1759;5642;7401;-329;15491;3827;26719;227366;146642,0;121,0;5500,0;30,0;420,0;-8,0
2020-05-10;Emilia-Romagna;1562;150;1712;5479;7191;-210;15760;3845;26796;231637;149276,0;77,0;4271,0;18,0;269,0;-5,0
2020-02-24;Friuli Venezia Giulia;0;0;0;0;0;0;0;0;0;58;;0,0;58,0;0,0;0,0;0,0
2020-02-25;Friuli Venezia Giulia;0;0;0;0;0;0;0;0;0;89;;0,0;31,0;0,0;0,0;0,0
2020-02-26;Friuli Venezia Giulia;0;0;0;0;0;0;0;0;0;114;;0,0;25,0;0,0;0,0;0,0
2020-02-27;Friuli Venezia Giulia;0;0;0;0;0;0;0;0;0;141;;0,0;27,0;0,0;0,0;0,0
2020-02-28;Friuli Venezia Giulia;0;0;0;0;0;0;0;0;0;169;;0,0;28,0;0,0;0,0;0,0
2020-02-29;Friuli Venezia Giulia;0;0;0;0;0;0;0;0;0;189;;0,0;20,0;0,0;0,0;0,0
2020-03-01;Friuli Venezia Giulia;0;0;0;6;6;6;0;0;6;243;;6,0;54,0;0,0;0,0;0,0
2020-03-02;Friuli Venezia Giulia;0;0;0;9;9;3;0;0;9;269;;3,0;26,0;0,0;0,0;0,0
2020-03-03;Friuli Venezia Giulia;1;0;1;12;13;4;0;0;13;354;;4,0;85,0;0,0;0,0;0,0
2020-03-04;Friuli Venezia Giulia;3;0;3;15;18;5;0;0;18;376;;5,0;22,0;0,0;0,0;0,0
2020-03-05;Friuli Venezia Giulia;4;0;4;17;21;3;0;0;21;397;;3,0;21,0;0,0;0,0;0,0
2020-03-06;Friuli Venezia Giulia;4;0;4;24;28;7;3;0;31;577;;10,0;180,0;0,0;3,0;0,0
2020-03-07;Friuli Venezia Giulia;7;1;8;31;39;11;3;0;42;577;;11,0;0,0;0,0;0,0;1,0
2020-03-08;Friuli Venezia Giulia;7;1;8;45;53;14;3;1;57;997;;15,0;420,0;1,0;0,0;0,0
2020-03-09;Friuli Venezia Giulia;18;1;19;70;89;36;3;1;93;1344;;36,0;347,0;0,0;0,0;0,0
2020-03-10;Friuli Venezia Giulia;27;6;33;77;110;21;3;3;116;1602;;23,0;258,0;2,0;0,0;5,0
2020-03-11;Friuli Venezia Giulia;16;5;21;89;110;0;10;6;126;2073;;10,0;471,0;3,0;7,0;-1,0
2020-03-12;Friuli Venezia Giulia;23;10;33;115;148;38;11;8;167;2604;;41,0;531,0;2,0;1,0;5,0
2020-03-13;Friuli Venezia Giulia;59;8;67;169;236;88;11;10;257;3149;;90,0;545,0;2,0;0,0;-2,0
2020-03-14;Friuli Venezia Giulia;67;11;78;193;271;35;17;13;301;3376;;44,0;227,0;3,0;6,0;3,0
2020-03-15;Friuli Venezia Giulia;98;12;110;206;316;45;17;14;347;3407;;46,0;31,0;1,0;0,0;1,0
2020-03-16;Friuli Venezia Giulia;96;19;115;231;346;30;18;22;386;4851;;39,0;1444,0;8,0;1,0;7,0
2020-03-17;Friuli Venezia Giulia;104;21;125;222;347;1;17;30;394;4958;;8,0;107,0;8,0;-1,0;2,0
2020-03-18;Friuli Venezia Giulia;128;27;155;261;416;69;15;31;462;4958;;68,0;0,0;1,0;-2,0;6,0
2020-03-19;Friuli Venezia Giulia;134;29;163;359;522;106;41;36;599;4052;;137,0;-906,0;5,0;26,0;2,0
2020-03-20;Friuli Venezia Giulia;143;32;175;380;555;33;63;38;656;4964;;57,0;912,0;2,0;22,0;3,0
2020-03-21;Friuli Venezia Giulia;152;37;189;477;666;111;82;42;790;5955;;134,0;991,0;4,0;19,0;5,0
2020-03-22;Friuli Venezia Giulia;163;47;210;528;738;72;89;47;874;6761;;84,0;806,0;5,0;7,0;10,0
2020-03-23;Friuli Venezia Giulia;185;41;226;545;771;33;105;54;930;7424;;56,0;663,0;7,0;16,0;-6,0
2020-03-24;Friuli Venezia Giulia;195;49;244;604;848;77;80;64;992;8526;;62,0;1102,0;10,0;-25,0;8,0
2020-03-25;Friuli Venezia Giulia;200;52;252;659;911;63;158;70;1139;9494;;147,0;968,0;6,0;78,0;3,0
2020-03-26;Friuli Venezia Giulia;212;54;266;688;954;43;197;72;1223;10721;;84,0;1227,0;2,0;39,0;2,0
2020-03-27;Friuli Venezia Giulia;222;57;279;748;1027;73;214;76;1317;11841;;94,0;1120,0;4,0;17,0;3,0
2020-03-28;Friuli Venezia Giulia;223;59;282;838;1120;93;229;87;1436;12723;;119,0;882,0;11,0;15,0;2,0
2020-03-29;Friuli Venezia Giulia;236;60;296;845;1141;21;241;98;1480;13397;;44,0;674,0;11,0;12,0;1,0
2020-03-30;Friuli Venezia Giulia;229;60;289;820;1109;-32;285;107;1501;14003;;21,0;606,0;9,0;44,0;0,0
2020-03-31;Friuli Venezia Giulia;215;60;275;885;1160;51;320;113;1593;14899;;92,0;896,0;6,0;35,0;0,0
2020-04-01;Friuli Venezia Giulia;206;60;266;940;1206;46;357;122;1685;15987;;92,0;1088,0;9,0;37,0;0,0
2020-04-02;Friuli Venezia Giulia;199;60;259;1035;1294;88;376;129;1799;17121;;114,0;1134,0;7,0;19,0;0,0
2020-04-03;Friuli Venezia Giulia;201;61;262;1062;1324;30;419;136;1879;19985;;80,0;2864,0;7,0;43,0;1,0
2020-04-04;Friuli Venezia Giulia;183;50;233;1103;1336;12;505;145;1986;21126;;107,0;1141,0;9,0;86,0;-11,0
2020-04-05;Friuli Venezia Giulia;185;50;235;1128;1363;27;531;154;2048;21652;;62,0;526,0;9,0;26,0;0,0
2020-04-06;Friuli Venezia Giulia;189;46;235;1161;1396;33;549;158;2103;22272;;55,0;620,0;4,0;18,0;-4,0
2020-04-07;Friuli Venezia Giulia;185;44;229;1150;1379;-17;610;164;2153;23536;;50,0;1264,0;6,0;61,0;-2,0
2020-04-08;Friuli Venezia Giulia;162;41;203;1212;1415;36;634;169;2218;24798;;65,0;1262,0;5,0;24,0;-3,0
2020-04-09;Friuli Venezia Giulia;167;37;204;1186;1390;-25;738;171;2299;26205;;81,0;1407,0;2,0;104,0;-4,0
2020-04-10;Friuli Venezia Giulia;167;33;200;1198;1398;8;772;179;2349;28097;;50,0;1892,0;8,0;34,0;-4,0
2020-04-11;Friuli Venezia Giulia;172;28;200;1182;1382;-16;826;185;2393;29685;;44,0;1588,0;6,0;54,0;-5,0
2020-04-12;Friuli Venezia Giulia;160;28;188;1138;1326;-56;910;195;2431;29988;;38,0;303,0;10,0;84,0;0,0
2020-04-13;Friuli Venezia Giulia;159;30;189;1118;1307;-19;973;202;2482;30941;;51,0;953,0;7,0;63,0;2,0
2020-04-14;Friuli Venezia Giulia;166;28;194;705;899;-408;1415;206;2520;31764;;38,0;823,0;4,0;442,0;-2,0
2020-04-15;Friuli Venezia Giulia;163;24;187;1207;1394;495;938;212;2544;33800;;24,0;2036,0;6,0;-477,0;-4,0
2020-04-16;Friuli Venezia Giulia;159;26;185;1145;1330;-64;1069;217;2616;35766;;72,0;1966,0;5,0;131,0;2,0
2020-04-17;Friuli Venezia Giulia;148;23;171;1257;1428;98;1027;220;2675;40030;;59,0;4264,0;3,0;-42,0;-3,0
2020-04-18;Friuli Venezia Giulia;141;27;168;1235;1403;-25;1106;222;2731;43293;;56,0;3263,0;2,0;79,0;4,0
2020-04-19;Friuli Venezia Giulia;140;25;165;1172;1337;-66;1183;225;2745;44622;27544,0;14,0;1329,0;3,0;77,0;-2,0
2020-04-20;Friuli Venezia Giulia;140;22;162;1028;1190;-147;1346;239;2775;45161;28777,0;30,0;539,0;14,0;163,0;-3,0
2020-04-21;Friuli Venezia Giulia;139;21;160;1162;1322;132;1229;241;2792;48500;31352,0;17,0;3339,0;2,0;-117,0;-1,0
2020-04-22;Friuli Venezia Giulia;134;20;154;1154;1308;-14;1263;246;2817;50869;32871,0;25,0;2369,0;5,0;34,0;-1,0
2020-04-23;Friuli Venezia Giulia;138;18;156;979;1135;-173;1467;256;2858;52918;34057,0;41,0;2049,0;10,0;204,0;-2,0
2020-04-24;Friuli Venezia Giulia;136;16;152;1168;1320;185;1304;258;2882;55502;35547,0;24,0;2584,0;2,0;-163,0;-2,0
2020-04-25;Friuli Venezia Giulia;122;15;137;947;1084;-236;1556;263;2903;58375;37211,0;21,0;2873,0;5,0;252,0;-1,0
2020-04-26;Friuli Venezia Giulia;129;13;142;1106;1248;164;1405;264;2917;59681;38202,0;14,0;1306,0;1,0;-151,0;-2,0
2020-04-27;Friuli Venezia Giulia;130;13;143;1115;1258;10;1448;271;2977;60940;39330,0;60,0;1259,0;7,0;43,0;0,0
2020-04-28;Friuli Venezia Giulia;136;13;149;1090;1239;-19;1478;278;2995;64151;41273,0;18,0;3211,0;7,0;30,0;0,0
2020-04-29;Friuli Venezia Giulia;134;12;146;1081;1227;-12;1498;285;3010;66769;42902,0;15,0;2618,0;7,0;20,0;-1,0
2020-04-30;Friuli Venezia Giulia;109;11;120;1050;1170;-57;1566;289;3025;67930;43691,0;15,0;1161,0;4,0;68,0;-1,0
2020-05-01;Friuli Venezia Giulia;131;6;137;978;1115;-55;1632;294;3041;71013;45566,0;16,0;3083,0;5,0;66,0;-5,0
2020-05-02;Friuli Venezia Giulia;131;5;136;973;1109;-6;1655;295;3059;73855;47259,0;18,0;2842,0;1,0;23,0;-1,0
2020-05-03;Friuli Venezia Giulia;131;6;137;950;1087;-22;1688;297;3072;74990;48041,0;13,0;1135,0;2,0;33,0;1,0
2020-05-04;Friuli Venezia Giulia;130;4;134;916;1050;-37;1727;299;3076;75421;48250,0;4,0;431,0;2,0;39,0;-2,0
2020-05-05;Friuli Venezia Giulia;120;4;124;860;984;-66;1798;303;3085;78510;50135,0;9,0;3089,0;4,0;71,0;0,0
2020-05-06;Friuli Venezia Giulia;115;3;118;844;962;-22;1826;306;3094;79429;50698,0;9,0;919,0;3,0;28,0;-1,0
2020-05-07;Friuli Venezia Giulia;109;2;111;816;927;-35;1872;308;3107;82012;51123,0;13,0;2583,0;2,0;46,0;-1,0
2020-05-08;Friuli Venezia Giulia;105;2;107;804;911;-16;1897;308;3116;82902;52784,0;9,0;890,0;0,0;25,0;0,0
2020-05-09;Friuli Venezia Giulia;101;3;104;765;869;-42;1947;308;3124;88384;55319,0;8,0;5482,0;0,0;50,0;1,0
2020-05-10;Friuli Venezia Giulia;98;3;101;750;851;-18;1969;310;3130;89449;56205,0;6,0;1065,0;2,0;22,0;0,0
2020-02-24;Lazio;1;1;2;0;2;0;1;0;3;124;;3,0;124,0;0,0;1,0;1,0
2020-02-25;Lazio;1;1;2;0;2;0;1;0;3;124;;0,0;0,0;0,0;0,0;0,0
2020-02-26;Lazio;0;0;0;0;0;-2;3;0;3;124;;0,0;0,0;0,0;2,0;-1,0
2020-02-27;Lazio;0;0;0;0;0;0;3;0;3;552;;0,0;428,0;0,0;0,0;0,0
2020-02-28;Lazio;0;0;0;0;0;0;3;0;3;611;;0,0;59,0;0,0;0,0;0,0
2020-02-29;Lazio;3;0;3;0;3;3;3;0;6;679;;3,0;68,0;0,0;0,0;0,0
2020-03-01;Lazio;3;0;3;0;3;0;3;0;6;724;;0,0;45,0;0,0;0,0;0,0
2020-03-02;Lazio;3;0;3;1;4;1;3;0;7;773;;1,0;49,0;0,0;0,0;0,0
2020-03-03;Lazio;10;0;10;1;11;7;3;0;14;877;;7,0;104,0;0,0;0,0;0,0
2020-03-04;Lazio;15;3;18;9;27;16;3;0;30;995;;16,0;118,0;0,0;0,0;3,0
2020-03-05;Lazio;20;7;27;14;41;14;3;0;44;1175;;14,0;180,0;0,0;0,0;4,0
2020-03-06;Lazio;26;8;34;16;50;9;3;1;54;1373;;10,0;198,0;1,0;0,0;1,0
2020-03-07;Lazio;43;8;51;21;72;22;3;1;76;1582;;22,0;209,0;0,0;0,0;0,0
2020-03-08;Lazio;47;8;55;26;81;9;3;3;87;1929;;11,0;347,0;2,0;0,0;0,0
2020-03-09;Lazio;55;8;63;31;94;13;3;5;102;1929;;15,0;0,0;2,0;0,0;0,0
2020-03-10;Lazio;50;15;65;34;99;5;11;6;116;3591;;14,0;1662,0;1,0;8,0;7,0
2020-03-11;Lazio;67;18;85;40;125;26;19;6;150;3591;;34,0;0,0;0,0;8,0;3,0
2020-03-12;Lazio;85;20;105;67;172;47;19;9;200;5592;;50,0;2001,0;3,0;0,0;2,0
2020-03-13;Lazio;122;24;146;96;242;70;24;11;277;6491;;77,0;899,0;2,0;5,0;4,0
2020-03-14;Lazio;181;25;206;114;320;78;24;13;357;7335;;80,0;844,0;2,0;0,0;1,0
2020-03-15;Lazio;223;31;254;142;396;76;24;16;436;8345;;79,0;1010,0;3,0;0,0;6,0
2020-03-16;Lazio;267;31;298;174;472;76;32;19;523;9330;;87,0;985,0;3,0;8,0;0,0
2020-03-17;Lazio;314;44;358;192;550;78;34;23;607;9436;;84,0;106,0;4,0;2,0;13,0
2020-03-18;Lazio;374;44;418;232;650;100;42;32;724;11145;;117,0;1709,0;9,0;8,0;0,0
2020-03-19;Lazio;426;45;471;270;741;91;44;38;823;11145;;99,0;0,0;6,0;2,0;1,0
2020-03-20;Lazio;537;47;584;328;912;171;53;43;1008;13889;;185,0;2744,0;5,0;9,0;2,0
2020-03-21;Lazio;591;70;661;425;1086;174;54;50;1190;13889;;182,0;0,0;7,0;1,0;23,0
2020-03-22;Lazio;671;79;750;522;1272;186;58;53;1383;17845;;193,0;3956,0;3,0;4,0;9,0
2020-03-23;Lazio;718;96;814;600;1414;142;63;63;1540;18371;;157,0;526,0;10,0;5,0;17,0
2020-03-24;Lazio;747;94;841;704;1545;131;103;80;1728;18371;;188,0;0,0;17,0;40,0;-2,0
2020-03-25;Lazio;805;101;906;769;1675;130;131;95;1901;20669;;173,0;2298,0;15,0;28,0;7,0
2020-03-26;Lazio;878;113;991;844;1835;160;155;106;2096;22771;;195,0;2102,0;11,0;24,0;12,0
2020-03-27;Lazio;992;126;1118;895;2013;178;164;118;2295;24106;;199,0;1335,0;12,0;9,0;13,0
2020-03-28;Lazio;985;133;1118;1063;2181;168;200;124;2505;27179;;210,0;3073,0;6,0;36,0;7,0
2020-03-29;Lazio;1062;133;1195;1167;2362;181;208;136;2706;27744;;201,0;565,0;12,0;8,0;0,0
2020-03-30;Lazio;1079;154;1233;1264;2497;135;267;150;2914;32846;;208,0;5102,0;14,0;59,0;21,0
2020-03-31;Lazio;1127;173;1300;1342;2642;145;291;162;3095;34677;;181,0;1831,0;12,0;24,0;19,0
2020-04-01;Lazio;1131;177;1308;1450;2758;116;337;169;3264;35810;;169,0;1133,0;7,0;46,0;4,0
2020-04-02;Lazio;1169;181;1350;1529;2879;121;369;185;3433;41575;;169,0;5765,0;16,0;32,0;4,0
2020-04-03;Lazio;1194;188;1382;1627;3009;130;392;199;3600;43776;;167,0;2201,0;14,0;23,0;7,0
2020-04-04;Lazio;1236;193;1429;1677;3106;97;439;212;3757;44624;;157,0;848,0;13,0;47,0;5,0
2020-04-05;Lazio;1235;197;1432;1754;3186;80;475;219;3880;44658;;123,0;34,0;7,0;36,0;4,0
2020-04-06;Lazio;1235;197;1432;1868;3300;114;502;229;4031;47470;;151,0;2812,0;10,0;27,0;0,0
2020-04-07;Lazio;1229;192;1421;1944;3365;65;546;238;4149;48874;;118,0;1404,0;9,0;44,0;-5,0
2020-04-08;Lazio;1241;196;1437;2011;3448;83;574;244;4266;55113;;117,0;6239,0;6,0;28,0;4,0
2020-04-09;Lazio;1244;198;1442;2090;3532;84;644;253;4429;58107;;163,0;2994,0;9,0;70,0;2,0
2020-04-10;Lazio;1236;201;1437;2196;3633;101;687;263;4583;61769;;154,0;3662,0;10,0;43,0;3,0
2020-04-11;Lazio;1264;203;1467;2263;3730;97;720;273;4723;65241;;140,0;3472,0;10,0;33,0;2,0
2020-04-12;Lazio;1268;201;1469;2348;3817;87;749;279;4845;68954;;122,0;3713,0;6,0;29,0;-2,0
2020-04-13;Lazio;1314;200;1514;2406;3920;103;764;284;4968;72746;;123,0;3792,0;5,0;15,0;-1,0
2020-04-14;Lazio;1344;199;1543;2479;4022;102;789;300;5111;74650;;143,0;1904,0;16,0;25,0;-1,0
2020-04-15;Lazio;1342;196;1538;2509;4047;25;874;311;5232;75584;;121,0;934,0;11,0;85,0;-3,0
2020-04-16;Lazio;1347;197;1544;2600;4144;97;920;316;5380;81993;;148,0;6409,0;5,0;46,0;1,0
2020-04-17;Lazio;1332;187;1519;2695;4214;70;978;332;5524;84755;;144,0;2762,0;16,0;58,0;-10,0
2020-04-18;Lazio;1376;186;1562;2720;4282;68;1046;340;5668;89553;;144,0;4798,0;8,0;68,0;-1,0
2020-04-19;Lazio;1370;185;1555;2766;4321;39;1093;341;5755;91807;22702,0;87,0;2254,0;1,0;47,0;-1,0
2020-04-20;Lazio;1388;185;1573;2792;4365;44;1101;349;5815;97823;23067,0;60,0;6016,0;8,0;8,0;0,0
2020-04-21;Lazio;1380;184;1564;2838;4402;37;1130;363;5895;100031;24046,0;80,0;2208,0;14,0;29,0;-1,0
2020-04-22;Lazio;1384;187;1571;2892;4463;61;1142;370;5975;104062;25244,0;80,0;4031,0;7,0;12,0;3,0
2020-04-23;Lazio;1385;186;1571;2915;4486;23;1193;375;6054;111073;26298,0;79,0;7011,0;5,0;51,0;-1,0
2020-04-24;Lazio;1396;184;1580;2912;4492;6;1256;384;6132;114317;86545,0;78,0;3244,0;9,0;63,0;-2,0
2020-04-25;Lazio;1421;183;1604;2957;4561;69;1276;387;6224;118354;90582,0;92,0;4037,0;3,0;20,0;-1,0
2020-04-26;Lazio;1442;161;1603;2970;4573;12;1347;389;6309;121677;93811,0;85,0;3323,0;2,0;71,0;-22,0
2020-04-27;Lazio;1464;143;1607;2955;4562;-11;1433;397;6392;124769;95719,0;83,0;3092,0;8,0;86,0;-18,0
2020-04-28;Lazio;1468;132;1600;2962;4562;0;1491;414;6467;128664;98968,0;75,0;3895,0;17,0;58,0;-11,0
2020-04-29;Lazio;1445;130;1575;2960;4535;-27;1579;431;6545;133503;103435,0;78,0;4839,0;17,0;88,0;-2,0
2020-04-30;Lazio;1417;115;1532;2936;4468;-67;1707;441;6616;137596;107497,0;71,0;4093,0;10,0;128,0;-15,0
2020-05-01;Lazio;1372;105;1477;2969;4446;-22;1744;482;6672;143804;111988,0;56,0;6208,0;41,0;37,0;-10,0
2020-05-02;Lazio;1370;96;1466;2986;4452;6;1807;497;6756;147078;114761,0;84,0;3274,0;15,0;63,0;-9,0
2020-05-03;Lazio;1346;95;1441;2944;4385;-67;1916;508;6809;150912;117796,0;53,0;3834,0;11,0;109,0;-1,0
2020-05-04;Lazio;1335;95;1430;2955;4385;0;1938;524;6847;153293;120095,0;38,0;2381,0;16,0;22,0;0,0
2020-05-05;Lazio;1315;91;1406;2964;4370;-15;2010;534;6914;157307;122541,0;67,0;4014,0;10,0;72,0;-4,0
2020-05-06;Lazio;1351;91;1442;2991;4433;63;2024;538;6995;160894;125897,0;81,0;3587,0;4,0;14,0;0,0
2020-05-07;Lazio;1291;89;1380;2968;4348;-85;2143;543;7034;165340;130351,0;39,0;4446,0;5,0;119,0;-2,0
2020-05-08;Lazio;1278;84;1362;2966;4328;-20;2209;549;7086;169499;133674,0;52,0;4159,0;6,0;66,0;-5,0
2020-05-09;Lazio;1277;82;1359;2986;4345;17;2235;553;7133;174448;137428,0;47,0;4949,0;4,0;26,0;-2,0
2020-05-10;Lazio;1265;84;1349;2937;4286;-59;2322;557;7165;178569;141233,0;32,0;4121,0;4,0;87,0;2,0
2020-02-24;Liguria;0;0;0;0;0;0;0;0;0;1;;0,0;1,0;0,0;0,0;0,0
2020-02-25;Liguria;1;0;1;0;1;1;0;0;1;39;;1,0;38,0;0,0;0,0;0,0
2020-02-26;Liguria;6;0;6;5;11;10;0;0;11;66;;10,0;27,0;0,0;0,0;0,0
2020-02-27;Liguria;9;0;9;10;19;8;0;0;19;78;;8,0;12,0;0,0;0,0;0,0
2020-02-28;Liguria;9;0;9;10;19;0;0;0;19;112;;0,0;34,0;0,0;0,0;0,0
2020-02-29;Liguria;4;1;5;33;38;19;4;0;42;121;;23,0;9,0;0,0;4,0;1,0
2020-03-01;Liguria;12;1;13;8;21;-17;4;0;25;121;;-17,0;0,0;0,0;0,0;0,0
2020-03-02;Liguria;12;1;13;5;18;-3;4;0;22;121;;-3,0;0,0;0,0;0,0;0,0
2020-03-03;Liguria;12;2;14;5;19;1;4;1;24;121;;2,0;0,0;1,0;0,0;1,0
2020-03-04;Liguria;10;3;13;8;21;2;4;1;26;133;;2,0;12,0;0,0;0,0;1,0
2020-03-05;Liguria;11;3;14;7;21;0;4;3;28;146;;2,0;13,0;2,0;0,0;0,0
2020-03-06;Liguria;12;5;17;7;24;3;5;3;32;229;;4,0;83,0;0,0;1,0;2,0
2020-03-07;Liguria;26;6;32;10;42;18;5;4;51;331;;19,0;102,0;1,0;0,0;1,0
2020-03-08;Liguria;39;11;50;17;67;25;5;6;78;401;;27,0;70,0;2,0;0,0;5,0
2020-03-09;Liguria;60;17;77;20;97;30;5;7;109;611;;31,0;210,0;1,0;0,0;6,0
2020-03-10;Liguria;57;29;86;42;128;31;5;8;141;694;;32,0;83,0;1,0;0,0;12,0
2020-03-11;Liguria;74;34;108;73;181;53;5;8;194;1025;;53,0;331,0;0,0;0,0;5,0
2020-03-12;Liguria;100;36;136;107;243;62;20;11;274;1174;;80,0;149,0;3,0;15,0;2,0
2020-03-13;Liguria;128;44;172;132;304;61;24;17;345;1442;;71,0;268,0;6,0;4,0;8,0
2020-03-14;Liguria;213;62;275;109;384;80;52;27;463;1750;;118,0;308,0;10,0;28,0;18,0
2020-03-15;Liguria;253;66;319;174;493;109;33;33;559;1973;;96,0;223,0;6,0;-19,0;4,0
2020-03-16;Liguria;255;73;328;247;575;82;42;50;667;2189;;108,0;216,0;17,0;9,0;7,0
2020-03-17;Liguria;299;85;384;277;661;86;57;60;778;2509;;111,0;320,0;10,0;15,0;12,0
2020-03-18;Liguria;401;100;501;243;744;83;70;73;887;2912;;109,0;403,0;13,0;13,0;15,0
2020-03-19;Liguria;491;112;603;280;883;139;85;91;1059;3348;;172,0;436,0;18,0;15,0;12,0
2020-03-20;Liguria;573;121;694;307;1001;118;101;119;1221;3794;;162,0;446,0;28,0;16,0;9,0
2020-03-21;Liguria;598;129;727;432;1159;158;125;152;1436;4304;;215,0;510,0;33,0;24,0;8,0
2020-03-22;Liguria;736;132;868;483;1351;192;143;171;1665;4995;;229,0;691,0;19,0;18,0;3,0
2020-03-23;Liguria;761;133;894;659;1553;202;159;212;1924;5538;;259,0;543,0;41,0;16,0;1,0
2020-03-24;Liguria;803;147;950;742;1692;139;193;231;2116;5992;;192,0;454,0;19,0;34,0;14,0
2020-03-25;Liguria;927;147;1074;752;1826;134;225;254;2305;6602;;189,0;610,0;23,0;32,0;0,0
2020-03-26;Liguria;998;154;1152;875;2027;201;260;280;2567;7304;;262,0;702,0;26,0;35,0;7,0
2020-03-27;Liguria;1023;157;1180;880;2060;33;305;331;2696;7804;;129,0;500,0;51,0;45,0;3,0
2020-03-28;Liguria;1031;167;1198;888;2086;26;378;358;2822;8177;;126,0;373,0;27,0;73,0;10,0
2020-03-29;Liguria;1077;166;1243;1036;2279;193;420;377;3076;9100;;254,0;923,0;19,0;42,0;-1,0
2020-03-30;Liguria;1142;175;1317;1066;2383;104;437;397;3217;9677;;141,0;577,0;20,0;17,0;9,0
2020-03-31;Liguria;1153;179;1332;1176;2508;125;480;428;3416;10376;;199,0;699,0;31,0;43,0;4,0
2020-04-01;Liguria;1114;179;1293;1352;2645;137;555;460;3660;11334;;244,0;958,0;32,0;75,0;0,0
2020-04-02;Liguria;1120;172;1292;1368;2660;15;634;488;3782;12069;;122,0;735,0;28,0;79,0;-7,0
2020-04-03;Liguria;1147;173;1320;1426;2746;86;700;519;3965;12934;;183,0;865,0;31,0;66,0;1,0
2020-04-04;Liguria;1121;169;1290;1604;2894;148;767;542;4203;14087;;238,0;1153,0;23,0;67,0;-4,0
2020-04-05;Liguria;1126;165;1291;1802;3093;199;800;556;4449;15047;;246,0;960,0;14,0;33,0;-4,0
2020-04-06;Liguria;1141;162;1303;1814;3117;24;837;595;4549;15533;;100,0;486,0;39,0;37,0;-3,0
2020-04-07;Liguria;1090;156;1246;1966;3212;95;925;620;4757;16579;;208,0;1046,0;25,0;88,0;-6,0
2020-04-08;Liguria;1109;153;1262;1983;3245;33;1007;654;4906;17521;;149,0;942,0;34,0;82,0;-3,0
2020-04-09;Liguria;1103;154;1257;1996;3253;8;1085;682;5020;18446;;114,0;925,0;28,0;78,0;1,0
2020-04-10;Liguria;1076;151;1227;2074;3301;48;1181;709;5191;19514;;171,0;1068,0;27,0;96,0;-3,0
2020-04-11;Liguria;1003;146;1149;2184;3333;32;1309;734;5376;20888;;185,0;1374,0;25,0;128,0;-5,0
2020-04-12;Liguria;1032;144;1176;2157;3333;0;1412;749;5494;21983;;118,0;1095,0;15,0;103,0;-2,0
2020-04-13;Liguria;1088;138;1226;2139;3365;32;1471;760;5596;23129;;102,0;1146,0;11,0;59,0;-6,0
2020-04-14;Liguria;967;133;1100;2366;3466;101;1549;793;5808;24446;;212,0;1317,0;33,0;78,0;-5,0
2020-04-15;Liguria;959;120;1079;2385;3464;-2;1665;807;5936;25793;;128,0;1347,0;14,0;116,0;-13,0
2020-04-16;Liguria;957;103;1060;2377;3437;-27;1774;828;6039;26945;;103,0;1152,0;21,0;109,0;-17,0
2020-04-17;Liguria;897;105;1002;2457;3459;22;1863;866;6188;28181;;149,0;1236,0;38,0;89,0;2,0
2020-04-18;Liguria;901;105;1006;2406;3412;-47;1992;897;6301;29322;;113,0;1141,0;31,0;129,0;0,0
2020-04-19;Liguria;885;101;986;2504;3490;78;2110;928;6528;31551;21103,0;227,0;2229,0;31,0;118,0;-4,0
2020-04-20;Liguria;878;102;980;2516;3496;6;2216;957;6669;33007;21979,0;141,0;1456,0;29,0;106,0;1,0
2020-04-21;Liguria;914;94;1008;2455;3463;-33;2311;990;6764;34186;22670,0;95,0;1179,0;33,0;95,0;-8,0
2020-04-22;Liguria;860;92;952;2524;3476;13;2420;1022;6918;35990;23756,0;154,0;1804,0;32,0;109,0;-2,0
2020-04-23;Liguria;783;91;874;2592;3466;-10;2536;1047;7049;37842;25045,0;131,0;1852,0;25,0;116,0;-1,0
2020-04-24;Liguria;760;87;847;2590;3437;-29;2660;1076;7173;39563;26040,0;124,0;1721,0;29,0;124,0;-4,0
2020-04-25;Liguria;759;83;842;2591;3433;-4;2775;1093;7301;41125;26898,0;128,0;1562,0;17,0;115,0;-4,0
2020-04-26;Liguria;748;82;830;2650;3480;47;2894;1114;7488;42607;27852,0;187,0;1482,0;21,0;119,0;-1,0
2020-04-27;Liguria;754;83;837;2743;3580;100;2934;1128;7642;44039;28739,0;154,0;1432,0;14,0;40,0;1,0
2020-04-28;Liguria;718;81;799;2772;3571;-9;3060;1141;7772;45719;29794,0;130,0;1680,0;13,0;126,0;-2,0
2020-04-29;Liguria;697;70;767;2809;3576;5;3161;1152;7889;47220;30669,0;117,0;1501,0;11,0;101,0;-11,0
2020-04-30;Liguria;676;69;745;2806;3551;-25;3275;1167;7993;48762;31520,0;104,0;1542,0;15,0;114,0;-1,0
2020-05-01;Liguria;666;68;734;2784;3518;-33;3424;1184;8126;51199;32794,0;133,0;2437,0;17,0;149,0;-1,0
2020-05-02;Liguria;647;68;715;2883;3598;80;3519;1195;8312;53202;34037,0;186,0;2003,0;11,0;95,0;0,0
2020-05-03;Liguria;627;68;695;2856;3551;-47;3599;1209;8359;54492;34613,0;47,0;1290,0;14,0;80,0;0,0
2020-05-04;Liguria;606;72;678;2830;3508;-43;3683;1221;8412;56092;35443,0;53,0;1600,0;12,0;84,0;4,0
2020-05-05;Liguria;583;68;651;2776;3427;-81;3816;1232;8475;57622;36150,0;63,0;1530,0;11,0;133,0;-4,0
2020-05-06;Liguria;548;59;607;2699;3306;-121;4002;1243;8551;59693;37177,0;76,0;2071,0;11,0;186,0;-9,0
2020-05-07;Liguria;525;57;582;2666;3248;-58;4143;1254;8645;61446;38071,0;94,0;1753,0;11,0;141,0;-2,0
2020-05-08;Liguria;517;46;563;2613;3176;-72;4282;1265;8723;63531;39145,0;78,0;2085,0;11,0;139,0;-11,0
2020-05-09;Liguria;501;42;543;2439;2982;-194;4480;1276;8738;64926;39600,0;15,0;1395,0;11,0;198,0;-4,0
2020-05-10;Liguria;481;41;522;2378;2900;-82;4607;1281;8788;67322;40751,0;50,0;2396,0;5,0;127,0;-1,0
2020-02-24;Lombardia;76;19;95;71;166;0;0;6;172;1463;;172,0;1463,0;6,0;0,0;19,0
2020-02-25;Lombardia;79;25;104;127;231;65;0;9;240;3700;;68,0;2237,0;3,0;0,0;6,0
2020-02-26;Lombardia;79;25;104;145;249;18;0;9;258;3208;;18,0;-492,0;0,0;0,0;0,0
2020-02-27;Lombardia;172;41;213;136;349;100;40;14;403;3320;;145,0;112,0;5,0;40,0;16,0
2020-02-28;Lombardia;235;47;282;192;474;125;40;17;531;4835;;128,0;1515,0;3,0;0,0;6,0
2020-02-29;Lombardia;256;80;336;216;552;78;40;23;615;5723;;84,0;888,0;6,0;0,0;33,0
2020-03-01;Lombardia;406;106;512;375;887;335;73;24;984;6879;;369,0;1156,0;1,0;33,0;26,0
2020-03-02;Lombardia;478;127;605;472;1077;190;139;38;1254;7925;;270,0;1046,0;14,0;66,0;21,0
2020-03-03;Lombardia;698;167;865;461;1326;249;139;55;1520;9577;;266,0;1652,0;17,0;0,0;40,0
2020-03-04;Lombardia;877;209;1086;411;1497;171;250;73;1820;12138;;300,0;2561,0;18,0;111,0;42,0
2020-03-05;Lombardia;1169;244;1413;364;1777;280;376;98;2251;12354;;431,0;216,0;25,0;126,0;35,0
2020-03-06;Lombardia;1622;309;1931;77;2008;231;469;135;2612;13556;;361,0;1202,0;37,0;93,0;65,0
2020-03-07;Lombardia;1661;359;2020;722;2742;734;524;154;3420;15778;;808,0;2222,0;19,0;55,0;50,0
2020-03-08;Lombardia;2217;399;2616;756;3372;630;550;267;4189;18534;;769,0;2756,0;113,0;26,0;40,0
2020-03-09;Lombardia;2802;440;3242;1248;4490;1118;646;333;5469;20135;;1280,0;1601,0;66,0;96,0;41,0
2020-03-10;Lombardia;3319;466;3785;642;4427;-63;896;468;5791;21479;;322,0;1344,0;135,0;250,0;26,0
2020-03-11;Lombardia;3852;560;4412;1351;5763;1336;900;617;7280;25629;;1489,0;4150,0;149,0;4,0;94,0
2020-03-12;Lombardia;4247;605;4852;2044;6896;1133;1085;744;8725;29534;;1445,0;3905,0;127,0;185,0;45,0
2020-03-13;Lombardia;4435;650;5085;2647;7732;836;1198;890;9820;32700;;1095,0;3166,0;146,0;113,0;45,0
2020-03-14;Lombardia;4898;732;5630;3429;9059;1327;1660;966;11685;37138;;1865,0;4438,0;76,0;462,0;82,0
2020-03-15;Lombardia;5500;767;6267;3776;10043;984;2011;1218;13272;40369;;1587,0;3231,0;252,0;351,0;35,0
2020-03-16;Lombardia;6171;823;6994;3867;10861;818;2368;1420;14649;43565;;1377,0;3196,0;202,0;357,0;56,0
2020-03-17;Lombardia;6953;879;7832;4263;12095;1234;2485;1640;16220;46449;;1571,0;2884,0;220,0;117,0;56,0
2020-03-18;Lombardia;7285;924;8209;4057;12266;171;3488;1959;17713;48983;;1493,0;2534,0;319,0;1003,0;45,0
2020-03-19;Lombardia;7387;1006;8393;5545;13938;1672;3778;2168;19884;52244;;2171,0;3261,0;209,0;290,0;82,0
2020-03-20;Lombardia;7735;1050;8785;6635;15420;1482;4295;2549;22264;57174;;2380,0;4930,0;381,0;517,0;44,0
2020-03-21;Lombardia;8258;1093;9351;8019;17370;1950;5050;3095;25515;66730;;3251,0;9556,0;546,0;755,0;43,0
2020-03-22;Lombardia;9439;1142;10581;7304;17885;515;5865;3456;27206;70598;;1691,0;3868,0;361,0;815,0;49,0
2020-03-23;Lombardia;9266;1183;10449;8461;18910;1025;6075;3776;28761;73242;;1555,0;2644,0;320,0;210,0;41,0
2020-03-24;Lombardia;9711;1194;10905;8963;19868;958;6657;4178;30703;76695;;1942,0;3453,0;402,0;582,0;11,0
2020-03-25;Lombardia;10026;1236;11262;9329;20591;723;7281;4474;32346;81666;;1643,0;4971,0;296,0;624,0;42,0
2020-03-26;Lombardia;10681;1263;11944;10245;22189;1598;7839;4861;34889;87713;;2543,0;6047,0;387,0;558,0;27,0
2020-03-27;Lombardia;11137;1292;12429;11466;23895;1706;8001;5402;37298;95860;;2409,0;8147,0;541,0;162,0;29,0
2020-03-28;Lombardia;11152;1319;12471;12038;24509;614;8962;5944;39415;102503;;2117,0;6643,0;542,0;961,0;27,0
2020-03-29;Lombardia;11613;1328;12941;12451;25392;883;9255;6360;41007;107398;;1592,0;4895,0;416,0;293,0;9,0
2020-03-30;Lombardia;11815;1330;13145;11861;25006;-386;10337;6818;42161;111057;;1154,0;3659,0;458,0;1082,0;2,0
2020-03-31;Lombardia;11883;1324;13207;11917;25124;118;10885;7199;43208;114640;;1047,0;3583,0;381,0;548,0;-6,0
2020-04-01;Lombardia;11927;1342;13269;12496;25765;641;11415;7593;44773;121449;;1565,0;6809,0;394,0;530,0;18,0
2020-04-02;Lombardia;11762;1351;13113;12763;25876;111;12229;7960;46065;128286;;1292,0;6837,0;367,0;814,0;9,0
2020-04-03;Lombardia;11802;1381;13183;13006;26189;313;13020;8311;47520;135051;;1455,0;6765,0;351,0;791,0;30,0
2020-04-04;Lombardia;12002;1326;13328;13892;27220;1031;13242;8656;49118;141877;;1598,0;6826,0;345,0;222,0;-55,0
2020-04-05;Lombardia;12009;1317;13326;14798;28124;904;13426;8905;50455;149984;;1337,0;8107,0;249,0;184,0;-9,0
2020-04-06;Lombardia;11914;1343;13257;15212;28469;345;13863;9202;51534;154989;;1079,0;5005,0;297,0;437,0;26,0
2020-04-07;Lombardia;11833;1305;13138;15205;28343;-126;14498;9484;52325;159331;;791,0;4342,0;282,0;635,0;-38,0
2020-04-08;Lombardia;11719;1257;12976;15569;28545;202;15147;9722;53414;167557;;1089,0;8226,0;238,0;649,0;-48,0
2020-04-09;Lombardia;11796;1236;13032;16042;29074;529;15706;10022;54802;176953;;1388,0;9396,0;300,0;559,0;-21,0
2020-04-10;Lombardia;11877;1202;13079;16451;29530;456;16280;10238;56048;186325;;1246,0;9372,0;216,0;574,0;-34,0
2020-04-11;Lombardia;12026;1174;13200;17058;30258;728;16823;10511;57592;196302;;1544,0;9977,0;273,0;543,0;-28,0
2020-04-12;Lombardia;11969;1176;13145;18120;31265;1007;17166;10621;59052;205832;;1460,0;9530,0;110,0;343,0;2,0
2020-04-13;Lombardia;12028;1143;13171;18764;31935;670;17478;10901;60314;211092;;1262,0;5260,0;280,0;312,0;-33,0
2020-04-14;Lombardia;12077;1122;13199;19164;32363;428;17821;11142;61326;214870;;1012,0;3778,0;241,0;343,0;-21,0
2020-04-15;Lombardia;12043;1074;13117;19804;32921;558;17855;11377;62153;221968;;827,0;7098,0;235,0;34,0;-48,0
2020-04-16;Lombardia;11356;1032;12388;20702;33090;169;18396;11608;63094;232674;;941,0;10706,0;231,0;541,0;-42,0
2020-04-17;Lombardia;10627;971;11598;21836;33434;344;18850;11851;64135;243513;;1041,0;10839,0;243,0;454,0;-61,0
2020-04-18;Lombardia;10042;947;10989;23206;34195;761;19136;12050;65381;255331;;1246,0;11818,0;199,0;286,0;-24,0
2020-04-19;Lombardia;10342;922;11264;23233;34497;302;19526;12213;66236;264155;183757,0;855,0;8824,0;163,0;390,0;-25,0
2020-04-20;Lombardia;10138;901;11039;23548;34587;90;20008;12376;66971;270486;173333,0;735,0;6331,0;163,0;482,0;-21,0
2020-04-21;Lombardia;9805;851;10656;23322;33978;-609;21374;12579;67931;277197;173333,0;960,0;6711,0;203,0;1366,0;-50,0
2020-04-22;Lombardia;9692;817;10509;23733;34242;264;22110;12740;69092;290699;184323,0;1161,0;13502,0;161,0;736,0;-34,0
2020-04-23;Lombardia;9192;790;9982;23891;33873;-369;23352;12940;70165;302715;190451,0;1073,0;12016,0;200,0;1242,0;-27,0
2020-04-24;Lombardia;8791;756;9547;24821;34368;495;23782;13106;71256;314298;196406,0;1091,0;11583,0;166,0;430,0;-34,0
2020-04-25;Lombardia;8489;724;9213;25260;34473;105;24227;13269;71969;326940;202827,0;713,0;12642,0;163,0;445,0;-32,0
2020-04-26;Lombardia;8481;706;9187;25979;35166;693;24398;13325;72889;337797;208471,0;920,0;10857,0;56,0;171,0;-18,0
2020-04-27;Lombardia;7525;680;8205;27236;35441;275;24589;13449;73479;342850;211523,0;590,0;5053,0;124,0;191,0;-26,0
2020-04-28;Lombardia;7280;655;7935;27809;35744;303;25029;13575;74348;351423;216526,0;869,0;8573,0;126,0;440,0;-25,0
2020-04-29;Lombardia;7120;634;7754;28368;36122;378;25333;13679;75134;365895;223952,0;786,0;14472,0;104,0;304,0;-21,0
2020-04-30;Lombardia;6834;605;7439;28772;36211;89;25749;13772;75732;376943;229880,0;598,0;11048,0;93,0;416,0;-29,0
2020-05-01;Lombardia;6628;563;7191;29282;36473;262;26136;13860;76469;390644;236822,0;737,0;13701,0;88,0;387,0;-42,0
2020-05-02;Lombardia;6529;545;7074;29593;36667;194;26146;14189;77002;403702;243383,0;533,0;13058,0;329,0;10,0;-18,0
2020-05-03;Lombardia;6609;532;7141;29785;36926;259;26371;14231;77528;410857;247176,0;526,0;7155,0;42,0;225,0;-13,0
2020-05-04;Lombardia;6414;532;6946;30361;37307;381;26504;14294;78105;418835;251661,0;577,0;7978,0;63,0;133,0;0,0
2020-05-05;Lombardia;6201;509;6710;30382;37092;-215;27124;14389;78605;425290;255292,0;500,0;6455,0;95,0;620,0;-23,0
2020-05-06;Lombardia;6079;480;6559;25194;31753;-5339;33005;14611;79369;439806;262964,0;764,0;14516,0;222,0;5881,0;-29,0
2020-05-07;Lombardia;5848;480;6328;25687;32015;262;33329;14745;80089;455294;262964,0;720,0;15488,0;134,0;324,0;0,0
2020-05-08;Lombardia;5702;400;6102;25881;31983;-32;33901;14839;80723;466287;277106,0;634,0;10993,0;94,0;572,0;-80,0
2020-05-09;Lombardia;5535;330;5865;24397;30262;-1721;36039;14924;81225;477765;282817,0;502,0;11478,0;85,0;2138,0;-70,0
2020-05-10;Lombardia;5428;348;5776;24414;30190;-72;36331;14986;81507;485134;287330,0;282,0;7369,0;62,0;292,0;18,0
2020-02-24;Marche;0;0;0;0;0;0;0;0;0;16;;0,0;16,0;0,0;0,0;0,0
2020-02-25;Marche;0;0;0;0;0;0;0;0;0;21;;0,0;5,0;0,0;0,0;0,0
2020-02-26;Marche;1;0;1;0;1;1;0;0;1;28;;1,0;7,0;0,0;0,0;0,0
2020-02-27;Marche;2;1;3;0;3;2;0;0;3;46;;2,0;18,0;0,0;0,0;1,0
2020-02-28;Marche;3;2;5;1;6;3;0;0;6;47;;3,0;1,0;0,0;0,0;1,0
2020-02-29;Marche;6;2;8;3;11;5;0;0;11;68;;5,0;21,0;0,0;0,0;0,0
2020-03-01;Marche;12;5;17;8;25;14;0;0;25;101;;14,0;33,0;0,0;0,0;3,0
2020-03-02;Marche;17;6;23;11;34;9;0;1;35;137;;10,0;36,0;1,0;0,0;1,0
2020-03-03;Marche;27;13;40;19;59;25;0;2;61;200;;26,0;63,0;1,0;0,0;7,0
2020-03-04;Marche;34;15;49;31;80;21;0;4;84;288;;23,0;88,0;2,0;0,0;2,0
2020-03-05;Marche;57;19;76;44;120;40;0;4;124;413;;40,0;125,0;0,0;0,0;4,0
2020-03-06;Marche;73;20;93;62;155;35;0;4;159;585;;35,0;172,0;0,0;0,0;1,0
2020-03-07;Marche;94;36;130;71;201;46;0;6;207;816;;48,0;231,0;2,0;0,0;16,0
2020-03-08;Marche;110;41;151;114;265;64;0;7;272;1025;;65,0;209,0;1,0;0,0;5,0
2020-03-09;Marche;136;47;183;130;313;48;0;10;323;1250;;51,0;225,0;3,0;0,0;6,0
2020-03-10;Marche;152;54;206;175;381;68;0;13;394;1437;;71,0;187,0;3,0;0,0;7,0
2020-03-11;Marche;212;66;278;183;461;80;0;18;479;1656;;85,0;219,0;5,0;0,0;12,0
2020-03-12;Marche;254;76;330;240;570;109;0;22;592;1907;;113,0;251,0;4,0;0,0;10,0
2020-03-13;Marche;337;85;422;276;698;128;0;27;725;2218;;133,0;311,0;5,0;0,0;9,0
2020-03-14;Marche;449;93;542;321;863;165;0;36;899;2561;;174,0;343,0;9,0;0,0;8,0
2020-03-15;Marche;521;98;619;468;1087;224;0;46;1133;2946;;234,0;385,0;10,0;0,0;5,0
2020-03-16;Marche;528;110;638;547;1185;98;0;57;1242;3225;;109,0;279,0;11,0;0,0;12,0
2020-03-17;Marche;599;109;708;594;1302;117;0;69;1371;3225;;129,0;0,0;12,0;0,0;-1,0
2020-03-18;Marche;638;119;757;719;1476;174;0;92;1568;4109;;197,0;884,0;23,0;0,0;10,0
2020-03-19;Marche;656;141;797;825;1622;146;0;115;1737;4512;;169,0;403,0;23,0;0,0;22,0
2020-03-20;Marche;704;138;842;1002;1844;222;0;137;1981;5170;;244,0;658,0;22,0;0,0;-3,0
2020-03-21;Marche;742;141;883;1114;1997;153;2;154;2153;5740;;172,0;570,0;17,0;2,0;3,0
2020-03-22;Marche;816;138;954;1277;2231;234;6;184;2421;6391;;268,0;651,0;30,0;4,0;-3,0
2020-03-23;Marche;882;148;1030;1328;2358;127;8;203;2569;6782;;148,0;391,0;19,0;2,0;10,0
2020-03-24;Marche;862;149;1011;1486;2497;139;8;231;2736;7229;;167,0;447,0;28,0;0,0;1,0
2020-03-25;Marche;938;148;1086;1553;2639;142;8;287;2934;7896;;198,0;667,0;56,0;0,0;-1,0
2020-03-26;Marche;977;166;1143;1652;2795;156;9;310;3114;8623;;180,0;727,0;23,0;1,0;18,0
2020-03-27;Marche;979;162;1141;1709;2850;55;10;336;3196;9060;;82,0;437,0;26,0;1,0;-4,0
2020-03-28;Marche;987;166;1153;1846;2999;149;10;364;3373;9884;;177,0;824,0;28,0;0,0;4,0
2020-03-29;Marche;1000;168;1168;1992;3160;161;12;386;3558;10431;;185,0;547,0;22,0;2,0;2,0
2020-03-30;Marche;998;167;1165;2086;3251;91;16;417;3684;10979;;126,0;548,0;31,0;4,0;-1,0
2020-03-31;Marche;946;169;1115;2237;3352;101;21;452;3825;11724;;141,0;745,0;35,0;5,0;2,0
2020-04-01;Marche;984;168;1152;2304;3456;104;29;477;3962;12296;;137,0;572,0;25,0;8,0;-1,0
2020-04-02;Marche;986;164;1150;2405;3555;99;40;503;4098;12943;;136,0;647,0;26,0;11,0;-4,0
2020-04-03;Marche;982;158;1140;2491;3631;76;42;557;4230;13678;;132,0;735,0;54,0;2,0;-6,0
2020-04-04;Marche;997;153;1150;2347;3497;-134;270;574;4341;14472;;111,0;794,0;17,0;228,0;-5,0
2020-04-05;Marche;987;151;1138;2440;3578;81;287;599;4464;15252;;123,0;780,0;25,0;17,0;-2,0
2020-04-06;Marche;1001;140;1141;2565;3706;128;296;612;4614;15919;;150,0;667,0;13,0;9,0;-11,0
2020-04-07;Marche;962;139;1101;2637;3738;32;342;630;4710;16619;;96,0;700,0;18,0;46,0;-1,0
2020-04-08;Marche;974;133;1107;2455;3562;-176;645;652;4859;17532;;149,0;913,0;22,0;303,0;-6,0
2020-04-09;Marche;945;133;1078;2323;3401;-161;885;669;4955;18194;;96,0;662,0;17,0;240,0;0,0
2020-04-10;Marche;925;127;1052;2264;3316;-85;1086;682;5084;18970;;129,0;776,0;13,0;201,0;-6,0
2020-04-11;Marche;960;118;1078;2153;3231;-85;1291;689;5211;20060;;127,0;1090,0;7,0;205,0;-9,0
2020-04-12;Marche;949;114;1063;2051;3114;-117;1489;700;5303;21057;;92,0;997,0;11,0;198,0;-4,0
2020-04-13;Marche;959;108;1067;2013;3080;-34;1588;713;5381;28379;;78,0;7322,0;13,0;99,0;-6,0
2020-04-14;Marche;937;106;1043;2052;3095;15;1603;728;5426;29160;;45,0;781,0;15,0;15,0;-2,0
2020-04-15;Marche;888;106;994;2103;3097;2;1660;746;5503;30329;;77,0;1169,0;18,0;57,0;0,0
2020-04-16;Marche;850;102;952;2172;3124;27;1694;764;5582;33778;;79,0;3449,0;18,0;34,0;-4,0
2020-04-17;Marche;839;94;933;2224;3157;33;1726;785;5668;37997;;86,0;4219,0;21,0;32,0;-8,0
2020-04-18;Marche;804;88;892;2280;3172;15;1754;795;5721;39909;;53,0;1912,0;10,0;28,0;-6,0
2020-04-19;Marche;799;86;885;2297;3182;10;1780;807;5769;41474;27099,0;48,0;1565,0;12,0;26,0;-2,0
2020-04-20;Marche;792;80;872;2340;3212;30;1792;822;5826;42782;28006,0;57,0;1308,0;15,0;12,0;-6,0
2020-04-21;Marche;784;78;862;2356;3218;6;1825;834;5877;44332;29090,0;51,0;1550,0;12,0;33,0;-2,0
2020-04-22;Marche;735;76;811;2419;3230;12;1849;845;5924;46492;30543,0;47,0;2160,0;11,0;24,0;-2,0
2020-04-23;Marche;727;71;798;2432;3230;0;1865;857;5952;47662;31673,0;28,0;1170,0;12,0;16,0;-5,0
2020-04-24;Marche;705;61;766;2507;3273;43;1890;865;6028;49163;33113,0;76,0;1501,0;8,0;25,0;-10,0
2020-04-25;Marche;689;58;747;2525;3272;-1;1912;874;6058;50996;34256,0;30,0;1833,0;9,0;22,0;-3,0
2020-04-26;Marche;668;58;726;2582;3308;36;1924;879;6111;52063;35107,0;53,0;1067,0;5,0;12,0;0,0
2020-04-27;Marche;667;58;725;2585;3310;2;1933;884;6127;52765;35617,0;16,0;702,0;5,0;9,0;0,0
2020-04-28;Marche;666;58;724;2610;3334;24;1948;893;6175;54313;36650,0;48,0;1548,0;9,0;15,0;0,0
2020-04-29;Marche;640;52;692;2655;3347;13;1964;899;6210;55905;37877,0;35,0;1592,0;6,0;16,0;-6,0
2020-04-30;Marche;465;48;513;2697;3210;-137;2131;906;6247;59488;39145,0;37,0;3583,0;7,0;167,0;-4,0
2020-05-01;Marche;413;44;457;2754;3211;1;2153;911;6275;61241;40123,0;28,0;1753,0;5,0;22,0;-4,0
2020-05-02;Marche;399;46;445;2760;3205;-6;2177;916;6298;62834;41156,0;23,0;1593,0;5,0;24,0;2,0
2020-05-03;Marche;400;43;443;2755;3198;-7;2194;927;6319;64412;42281,0;21,0;1578,0;11,0;17,0;-3,0
2020-05-04;Marche;389;44;433;2773;3206;8;2225;932;6363;65398;42838,0;44,0;986,0;5,0;31,0;1,0
2020-05-05;Marche;387;42;429;2790;3219;13;2237;936;6392;67256;44045,0;29,0;1858,0;4,0;12,0;-2,0
2020-05-06;Marche;353;42;395;2841;3236;17;2242;943;6421;69037;45026,0;29,0;1781,0;7,0;5,0;0,0
2020-05-07;Marche;328;41;369;2878;3247;11;2257;948;6452;71017;46258,0;31,0;1980,0;5,0;15,0;-1,0
2020-05-08;Marche;303;38;341;2897;3238;-9;2278;954;6470;72504;47092,0;18,0;1487,0;6,0;21,0;-3,0
2020-05-09;Marche;285;32;317;2913;3230;-8;2305;958;6493;73965;47827,0;23,0;1461,0;4,0;27,0;-6,0
2020-05-10;Marche;284;30;314;2937;3251;21;2322;960;6533;76367;49194,0;40,0;2402,0;2,0;17,0;-2,0
2020-02-24;Molise;0;0;0;0;0;0;0;0;0;0;;0,0;0,0;0,0;0,0;0,0
2020-02-25;Molise;0;0;0;0;0;0;0;0;0;0;;0,0;0,0;0,0;0,0;0,0
2020-02-26;Molise;0;0;0;0;0;0;0;0;0;0;;0,0;0,0;0,0;0,0;0,0
2020-02-27;Molise;0;0;0;0;0;0;0;0;0;0;;0,0;0,0;0,0;0,0;0,0
2020-02-28;Molise;0;0;0;0;0;0;0;0;0;0;;0,0;0,0;0,0;0,0;0,0
2020-02-29;Molise;0;0;0;0;0;0;0;0;0;0;;0,0;0,0;0,0;0,0;0,0
2020-03-01;Molise;0;0;0;0;0;0;0;0;0;6;;0,0;6,0;0,0;0,0;0,0
2020-03-02;Molise;0;0;0;0;0;0;0;0;0;13;;0,0;7,0;0,0;0,0;0,0
2020-03-03;Molise;3;0;3;0;3;3;0;0;3;13;;3,0;0,0;0,0;0,0;0,0
2020-03-04;Molise;3;0;3;0;3;0;0;0;3;19;;0,0;6,0;0,0;0,0;0,0
2020-03-05;Molise;4;0;4;3;7;4;0;0;7;24;;4,0;5,0;0,0;0,0;0,0
2020-03-06;Molise;3;2;5;7;12;5;0;0;12;104;;5,0;80,0;0,0;0,0;2,0
2020-03-07;Molise;3;2;5;9;14;2;0;0;14;112;;2,0;8,0;0,0;0,0;0,0
2020-03-08;Molise;4;2;6;8;14;0;0;0;14;116;;0,0;4,0;0,0;0,0;0,0
2020-03-09;Molise;4;2;6;8;14;0;0;0;14;212;;0,0;96,0;0,0;0,0;0,0
2020-03-10;Molise;3;3;6;9;15;1;0;0;15;225;;1,0;13,0;0,0;0,0;1,0
2020-03-11;Molise;4;3;7;9;16;1;0;0;16;233;;1,0;8,0;0,0;0,0;0,0
2020-03-12;Molise;4;3;7;9;16;0;0;0;16;238;;0,0;5,0;0,0;0,0;0,0
2020-03-13;Molise;5;3;8;9;17;1;0;0;17;243;;1,0;5,0;0,0;0,0;0,0
2020-03-14;Molise;5;3;8;9;17;0;0;0;17;247;;0,0;4,0;0,0;0,0;0,0
2020-03-15;Molise;3;4;7;10;17;0;0;0;17;248;;0,0;1,0;0,0;0,0;1,0
2020-03-16;Molise;3;5;8;7;15;-2;5;1;21;253;;4,0;5,0;1,0;5,0;1,0
2020-03-17;Molise;7;5;12;7;19;4;5;1;25;301;;4,0;48,0;0,0;0,0;0,0
2020-03-18;Molise;7;6;13;8;21;2;6;1;28;361;;3,0;60,0;0,0;1,0;1,0
2020-03-19;Molise;19;6;25;13;38;17;6;2;46;426;;18,0;65,0;1,0;0,0;0,0
2020-03-20;Molise;20;6;26;13;39;1;6;5;50;426;;4,0;0,0;3,0;0,0;0,0
2020-03-21;Molise;21;6;27;20;47;8;7;7;61;449;;11,0;23,0;2,0;1,0;0,0
2020-03-22;Molise;24;7;31;21;52;5;7;7;66;532;;5,0;83,0;0,0;0,0;1,0
2020-03-23;Molise;25;7;32;18;50;-2;10;7;67;532;;1,0;0,0;0,0;3,0;0,0
2020-03-24;Molise;27;7;34;21;55;5;10;8;73;572;;6,0;40,0;1,0;0,0;0,0
2020-03-25;Molise;26;7;33;20;53;-2;12;8;73;580;;0,0;8,0;0,0;2,0;0,0
2020-03-26;Molise;27;8;35;46;81;28;14;8;103;670;;30,0;90,0;0,0;2,0;1,0
2020-03-27;Molise;26;9;35;51;86;5;14;9;109;710;;6,0;40,0;1,0;0,0;1,0
2020-03-28;Molise;26;9;35;63;98;12;16;9;123;807;;14,0;97,0;0,0;2,0;0,0
2020-03-29;Molise;25;9;34;66;100;2;18;9;127;918;;4,0;111,0;0,0;2,0;0,0
2020-03-30;Molise;27;8;35;72;107;7;18;9;134;955;;7,0;37,0;0,0;0,0;-1,0
2020-03-31;Molise;29;8;37;80;117;10;18;9;144;1049;;10,0;94,0;0,0;0,0;0,0
2020-04-01;Molise;32;8;40;91;131;14;19;10;160;1157;;16,0;108,0;1,0;1,0;0,0
2020-04-02;Molise;30;8;38;95;133;2;21;11;165;1229;;5,0;72,0;1,0;2,0;0,0
2020-04-03;Molise;31;8;39;105;144;11;21;11;176;1378;;11,0;149,0;0,0;0,0;0,0
2020-04-04;Molise;31;6;37;134;171;27;24;11;206;1504;;30,0;126,0;0,0;3,0;-2,0
2020-04-05;Molise;33;6;39;148;187;16;24;13;224;1504;;18,0;0,0;2,0;0,0;0,0
2020-04-06;Molise;34;5;39;148;187;0;24;13;224;1546;;0,0;42,0;0,0;0,0;-1,0
2020-04-07;Molise;35;5;40;145;185;-2;26;13;224;1581;;0,0;35,0;0,0;2,0;0,0
2020-04-08;Molise;30;4;34;147;181;-4;32;13;226;2002;;2,0;421,0;0,0;6,0;-1,0
2020-04-09;Molise;30;4;34;155;189;8;32;13;234;2069;;8,0;67,0;0,0;0,0;0,0
2020-04-10;Molise;28;4;32;161;193;4;37;13;243;2069;;9,0;0,0;0,0;5,0;0,0
2020-04-11;Molise;28;4;32;161;193;0;39;14;246;2201;;3,0;132,0;1,0;2,0;0,0
2020-04-12;Molise;27;4;31;171;202;9;40;15;257;2471;;11,0;270,0;1,0;1,0;0,0
2020-04-13;Molise;28;4;32;170;202;0;40;15;257;2522;;0,0;51,0;0,0;0,0;0,0
2020-04-14;Molise;26;4;30;170;200;-2;42;15;257;2522;;0,0;0,0;0,0;2,0;0,0
2020-04-15;Molise;27;4;31;175;206;6;42;15;263;2855;;6,0;333,0;0,0;0,0;0,0
2020-04-16;Molise;25;4;29;174;203;-3;44;16;263;2967;;0,0;112,0;1,0;2,0;0,0
2020-04-17;Molise;26;4;30;178;208;5;45;16;269;3082;;6,0;115,0;0,0;1,0;0,0
2020-04-18;Molise;27;4;31;178;209;1;44;16;269;3082;;0,0;0,0;0,0;-1,0;0,0
2020-04-19;Molise;27;4;31;184;215;6;47;17;279;3584;3482,0;10,0;502,0;1,0;3,0;0,0
2020-04-20;Molise;27;2;29;184;213;-2;50;18;281;3783;3683,0;2,0;199,0;1,0;3,0;-2,0
2020-04-21;Molise;27;2;29;184;213;0;51;18;282;4124;4015,0;1,0;341,0;0,0;1,0;0,0
2020-04-22;Molise;21;2;23;182;205;-8;60;19;284;4425;4252,0;2,0;301,0;1,0;9,0;0,0
2020-04-23;Molise;19;1;20;178;198;-7;66;20;284;4564;4478,0;0,0;139,0;1,0;6,0;-1,0
2020-04-24;Molise;19;1;20;180;200;2;67;20;287;4805;4718,0;3,0;241,0;0,0;1,0;0,0
2020-04-25;Molise;19;1;20;178;198;-2;73;21;292;5191;5089,0;5,0;386,0;1,0;6,0;0,0
2020-04-26;Molise;20;1;21;179;200;2;75;21;296;5567;5334,0;4,0;376,0;0,0;2,0;0,0
2020-04-27;Molise;20;1;21;179;200;0;75;21;296;5656;5423,0;0,0;89,0;0,0;0,0;0,0
2020-04-28;Molise;18;1;19;176;195;-5;81;21;297;5776;5538,0;1,0;120,0;0,0;6,0;0,0
2020-04-29;Molise;17;1;18;175;193;-2;83;21;297;5910;5857,0;0,0;134,0;0,0;2,0;0,0
2020-04-30;Molise;17;1;18;172;190;-3;87;21;298;6446;6228,0;1,0;536,0;0,0;4,0;0,0
2020-05-01;Molise;17;1;18;172;190;0;89;21;300;6463;6450,0;2,0;17,0;0,0;2,0;0,0
2020-05-02;Molise;9;1;10;172;182;-8;98;21;301;7075;6808,0;1,0;612,0;0,0;9,0;0,0
2020-05-03;Molise;8;1;9;172;181;-1;98;22;301;7075;6808,0;0,0;0,0;1,0;0,0;0,0
2020-05-04;Molise;9;1;10;168;178;-3;101;22;301;7328;7057,0;0,0;253,0;0,0;3,0;0,0
2020-05-05;Molise;9;1;10;167;177;-1;102;22;301;7528;7252,0;0,0;200,0;0,0;1,0;0,0
2020-05-06;Molise;9;0;9;170;179;2;103;22;304;7896;7604,0;3,0;368,0;0,0;1,0;-1,0
2020-05-07;Molise;8;0;8;162;170;-9;113;22;305;8237;7912,0;1,0;341,0;0,0;10,0;0,0
2020-05-08;Molise;6;0;6;178;184;14;121;22;327;8502;8177,0;22,0;265,0;0,0;8,0;0,0
2020-05-09;Molise;8;0;8;197;205;21;120;22;347;8691;8375,0;20,0;189,0;0,0;-1,0;0,0
2020-05-10;Molise;9;0;9;209;218;13;130;22;370;9164;9008,0;23,0;473,0;0,0;10,0;0,0
2020-02-24;Trentino-Alto Adige;0;0;0;0;0;0;0;0;0;1;;0,0;1,0;0,0;0,0;0,0
2020-02-25;Trentino-Alto Adige;1;0;1;0;1;1;0;0;1;1;;1,0;0,0;0,0;0,0;0,0
2020-02-26;Trentino-Alto Adige;1;0;1;0;1;0;0;0;1;1;;0,0;0,0;0,0;0,0;0,0
2020-02-27;Trentino-Alto Adige;1;0;1;0;1;0;0;0;1;2;;0,0;1,0;0,0;0,0;0,0
2020-02-28;Trentino-Alto Adige;1;0;1;0;1;0;0;0;1;2;;0,0;0,0;0,0;0,0;0,0
2020-02-29;Trentino-Alto Adige;1;0;1;0;1;0;0;0;1;16;;0,0;14,0;0,0;0,0;0,0
2020-03-01;Trentino-Alto Adige;1;0;1;0;1;0;0;0;1;20;;0,0;4,0;0,0;0,0;0,0
2020-03-02;Trentino-Alto Adige;1;0;1;0;1;0;0;0;1;20;;0,0;0,0;0,0;0,0;0,0
2020-03-03;Trentino-Alto Adige;1;0;1;0;1;0;0;0;1;20;;0,0;0,0;0,0;0,0;0,0
2020-03-04;Trentino-Alto Adige;1;0;1;0;1;0;0;0;1;20;;0,0;0,0;0,0;0,0;0,0
2020-03-05;Trentino-Alto Adige;1;0;1;0;1;0;0;0;1;20;;0,0;0,0;0,0;0,0;0,0
2020-03-06;Trentino-Alto Adige;4;0;4;0;4;3;0;0;4;36;;3,0;16,0;0,0;0,0;0,0
2020-03-07;Trentino-Alto Adige;8;0;8;1;9;5;0;0;9;36;;5,0;0,0;0,0;0,0;0,0
2020-03-08;Trentino-Alto Adige;8;0;8;1;9;0;0;0;9;36;;0,0;0,0;0,0;0,0;0,0
2020-03-09;Trentino-Alto Adige;8;0;8;1;9;0;0;0;9;36;;0,0;0,0;0,0;0,0;0,0
2020-03-10;Trentino-Alto Adige;17;1;18;20;38;29;0;0;38;36;;29,0;0,0;0,0;0,0;1,0
2020-03-11;Trentino-Alto Adige;8;4;12;63;75;37;0;0;75;75;;37,0;39,0;0,0;0,0;3,0
2020-03-12;Trentino-Alto Adige;21;4;25;78;103;28;0;1;104;607;;29,0;532,0;1,0;0,0;0,0
2020-03-13;Trentino-Alto Adige;20;5;25;98;123;20;0;2;125;811;;21,0;204,0;1,0;0,0;1,0
2020-03-14;Trentino-Alto Adige;26;7;33;137;170;47;0;3;173;1135;;48,0;324,0;1,0;0,0;2,0
2020-03-15;Trentino-Alto Adige;50;4;54;145;199;29;0;5;204;1497;;31,0;362,0;2,0;0,0;-3,0
2020-03-16;Trentino-Alto Adige;53;11;64;171;235;36;0;6;241;1740;;37,0;243,0;1,0;0,0;7,0
2020-03-17;Trentino-Alto Adige;71;11;82;200;282;47;1;8;291;2149;;50,0;409,0;2,0;1,0;0,0
2020-03-18;Trentino-Alto Adige;79;18;97;269;366;84;1;9;376;2844;;85,0;695,0;1,0;0,0;7,0
2020-03-19;Trentino-Alto Adige;87;18;105;316;421;55;1;14;436;3568;;60,0;724,0;5,0;0,0;0,0
2020-03-20;Trentino-Alto Adige;99;24;123;407;530;109;1;17;548;4433;;112,0;865,0;3,0;0,0;6,0
2020-03-21;Trentino-Alto Adige;127;30;157;443;600;70;1;20;621;5179;;73,0;746,0;3,0;0,0;6,0
2020-03-22;Trentino-Alto Adige;146;32;178;470;648;48;7;23;678;5718;;57,0;539,0;3,0;6,0;2,0
2020-03-23;Trentino-Alto Adige;145;33;178;510;688;40;7;29;724;6084;;46,0;366,0;6,0;0,0;1,0
2020-03-24;Trentino-Alto Adige;166;38;204;495;699;11;44;38;781;6509;;57,0;425,0;9,0;37,0;5,0
2020-03-25;Trentino-Alto Adige;190;40;230;518;748;49;67;43;858;6649;;77,0;140,0;5,0;23,0;2,0
2020-03-26;Trentino-Alto Adige;223;43;266;525;791;43;67;48;906;7744;;48,0;1095,0;5,0;0,0;3,0
2020-03-27;Trentino-Alto Adige;249;45;294;539;833;42;110;60;1003;8520;;97,0;776,0;12,0;43,0;2,0
2020-03-28;Trentino-Alto Adige;225;51;276;653;929;96;116;64;1109;9168;;106,0;648,0;4,0;6,0;6,0
2020-03-29;Trentino-Alto Adige;234;56;290;744;1034;105;116;64;1214;10137;;105,0;969,0;0,0;0,0;5,0
2020-03-30;Trentino-Alto Adige;231;62;293;805;1098;64;153;74;1325;10640;;111,0;503,0;10,0;37,0;6,0
2020-03-31;Trentino-Alto Adige;249;62;311;831;1142;44;153;76;1371;11275;;46,0;635,0;2,0;0,0;0,0
2020-04-01;Trentino-Alto Adige;269;57;326;786;1112;-30;190;116;1418;11951;;47,0;676,0;40,0;37,0;-5,0
2020-04-02;Trentino-Alto Adige;279;60;339;821;1160;48;190;129;1479;12677;;61,0;726,0;13,0;0,0;3,0
2020-04-03;Trentino-Alto Adige;291;60;351;858;1209;49;211;139;1559;13976;;80,0;1299,0;10,0;21,0;0,0
2020-04-04;Trentino-Alto Adige;291;61;352;849;1201;-8;245;146;1592;15045;;33,0;1069,0;7,0;34,0;1,0
2020-04-05;Trentino-Alto Adige;239;53;292;934;1226;25;260;158;1644;15723;;52,0;678,0;12,0;15,0;-8,0
2020-04-06;Trentino-Alto Adige;245;52;297;963;1260;34;298;164;1722;16825;;78,0;1102,0;6,0;38,0;-1,0
2020-04-07;Trentino-Alto Adige;325;64;389;912;1301;41;336;174;1811;17761;;89,0;936,0;10,0;38,0;12,0
2020-04-08;Trentino-Alto Adige;268;65;333;948;1281;-20;371;183;1835;18865;;24,0;1104,0;9,0;35,0;1,0
2020-04-09;Trentino-Alto Adige;263;64;327;988;1315;34;401;187;1903;19875;;68,0;1010,0;4,0;30,0;-1,0
2020-04-10;Trentino-Alto Adige;258;58;316;1001;1317;2;447;191;1955;20866;;52,0;991,0;4,0;46,0;-6,0
2020-04-11;Trentino-Alto Adige;246;56;302;967;1269;-48;488;200;1957;22186;;2,0;1320,0;9,0;41,0;-2,0
2020-04-12;Trentino-Alto Adige;183;45;228;1287;1515;246;378;205;2098;23246;;141,0;1060,0;5,0;-110,0;-11,0
2020-04-13;Trentino-Alto Adige;190;41;231;1306;1537;22;400;212;2149;24157;;51,0;911,0;7,0;22,0;-4,0
2020-04-14;Trentino-Alto Adige;177;39;216;1348;1564;27;406;214;2184;24457;;35,0;300,0;2,0;6,0;-2,0
2020-04-15;Trentino-Alto Adige;166;32;198;1378;1576;12;425;223;2224;25370;;40,0;913,0;9,0;19,0;-7,0
2020-04-16;Trentino-Alto Adige;180;34;214;1379;1593;17;449;225;2267;26416;;43,0;1046,0;2,0;24,0;2,0
2020-04-17;Trentino-Alto Adige;181;32;213;1369;1582;-11;480;234;2296;27698;;29,0;1282,0;9,0;31,0;-2,0
2020-04-18;Trentino-Alto Adige;179;28;207;1349;1556;-26;530;239;2325;28888;;29,0;1190,0;5,0;50,0;-4,0
2020-04-19;Trentino-Alto Adige;162;23;185;1381;1566;10;569;245;2380;30361;14783,0;55,0;1473,0;6,0;39,0;-5,0
2020-04-20;Trentino-Alto Adige;160;19;179;1361;1540;-26;605;249;2394;31381;15089,0;14,0;1020,0;4,0;36,0;-4,0
2020-04-21;Trentino-Alto Adige;159;20;179;1357;1536;-4;623;251;2410;31987;15405,0;16,0;606,0;2,0;18,0;1,0
2020-04-22;Trentino-Alto Adige;157;19;176;1336;1512;-24;648;256;2416;32722;15736,0;6,0;735,0;5,0;25,0;-1,0
2020-04-23;Trentino-Alto Adige;141;17;158;1336;1494;-18;680;261;2435;33994;16442,0;19,0;1272,0;5,0;32,0;-2,0
2020-04-24;Trentino-Alto Adige;148;16;164;929;1093;-401;1100;263;2456;35062;17024,0;21,0;1068,0;2,0;420,0;-1,0
2020-04-25;Trentino-Alto Adige;141;14;155;880;1035;-58;1176;265;2476;36608;17573,0;20,0;1546,0;2,0;76,0;-2,0
2020-04-26;Trentino-Alto Adige;138;14;152;842;994;-41;1218;269;2481;37431;17895,0;5,0;823,0;4,0;42,0;0,0
2020-04-27;Trentino-Alto Adige;150;16;166;774;940;-54;1286;270;2496;38640;18423,0;15,0;1209,0;1,0;68,0;2,0
2020-04-28;Trentino-Alto Adige;136;15;151;759;910;-30;1316;272;2498;39130;18567,0;2,0;490,0;2,0;30,0;-1,0
2020-04-29;Trentino-Alto Adige;119;14;133;712;845;-65;1388;274;2507;40218;18844,0;9,0;1088,0;2,0;72,0;-1,0
2020-04-30;Trentino-Alto Adige;126;13;139;663;802;-43;1441;275;2518;41297;19178,0;11,0;1079,0;1,0;53,0;-1,0
2020-05-01;Trentino-Alto Adige;112;11;123;634;757;-45;1493;278;2528;42903;19705,0;10,0;1606,0;3,0;52,0;-2,0
2020-05-02;Trentino-Alto Adige;113;10;123;580;703;-54;1553;279;2535;43804;20036,0;7,0;901,0;1,0;60,0;-1,0
2020-05-03;Trentino-Alto Adige;109;11;120;545;665;-38;1590;281;2536;44240;20166,0;1,0;436,0;2,0;37,0;1,0
2020-05-04;Trentino-Alto Adige;103;10;113;523;636;-29;1621;284;2541;44673;20333,0;5,0;433,0;3,0;31,0;-1,0
2020-05-05;Trentino-Alto Adige;99;11;110;502;612;-24;1644;286;2542;45264;20561,0;1,0;591,0;2,0;23,0;1,0
2020-05-06;Trentino-Alto Adige;99;11;110;469;579;-33;1678;286;2543;46228;20872,0;1,0;964,0;0,0;34,0;0,0
2020-05-07;Trentino-Alto Adige;87;11;98;453;551;-28;1715;286;2552;47091;21284,0;9,0;863,0;0,0;37,0;0,0
2020-05-08;Trentino-Alto Adige;78;9;87;415;502;-49;1767;289;2558;47908;21572,0;6,0;817,0;3,0;52,0;-2,0
2020-05-09;Trentino-Alto Adige;55;9;64;409;473;-29;1804;290;2567;48858;21969,0;9,0;950,0;1,0;37,0;0,0
2020-05-10;Trentino-Alto Adige;61;8;69;390;459;-14;1820;290;2569;49571;22265,0;2,0;713,0;0,0;16,0;-1,0
2020-02-24;Trentino-Alto Adige;0;0;0;0;0;0;0;0;0;3;;0,0;3,0;0,0;0,0;0,0
2020-02-25;Trentino-Alto Adige;0;0;0;0;0;0;0;0;0;3;;0,0;0,0;0,0;0,0;0,0
2020-02-26;Trentino-Alto Adige;0;0;0;0;0;0;0;0;0;3;;0,0;0,0;0,0;0,0;0,0
2020-02-27;Trentino-Alto Adige;0;0;0;0;0;0;0;0;0;32;;0,0;29,0;0,0;0,0;0,0
2020-02-28;Trentino-Alto Adige;0;0;0;0;0;0;0;0;0;32;;0,0;0,0;0,0;0,0;0,0
2020-02-29;Trentino-Alto Adige;0;0;0;0;0;0;0;0;0;43;;0,0;11,0;0,0;0,0;0,0
2020-03-01;Trentino-Alto Adige;0;0;0;0;0;0;0;0;0;122;;0,0;79,0;0,0;0,0;0,0
2020-03-02;Trentino-Alto Adige;0;0;0;0;0;0;0;0;0;122;;0,0;0,0;0,0;0,0;0,0
2020-03-03;Trentino-Alto Adige;1;0;1;3;4;4;0;0;4;122;;4,0;0,0;0,0;0,0;0,0
2020-03-04;Trentino-Alto Adige;1;0;1;4;5;1;0;0;5;122;;1,0;0,0;0,0;0,0;0,0
2020-03-05;Trentino-Alto Adige;2;0;2;5;7;2;0;0;7;122;;2,0;0,0;0,0;0,0;0,0
2020-03-06;Trentino-Alto Adige;4;0;4;6;10;3;0;0;10;122;;3,0;0,0;0,0;0,0;0,0
2020-03-07;Trentino-Alto Adige;6;1;7;7;14;4;0;0;14;194;;4,0;72,0;0,0;0,0;1,0
2020-03-08;Trentino-Alto Adige;7;2;9;14;23;9;0;0;23;228;;9,0;34,0;0,0;0,0;1,0
2020-03-09;Trentino-Alto Adige;10;2;12;21;33;10;0;0;33;267;;10,0;39,0;0,0;0,0;0,0
2020-03-10;Trentino-Alto Adige;19;3;22;28;50;17;2;0;52;399;;19,0;132,0;0,0;2,0;1,0
2020-03-11;Trentino-Alto Adige;28;4;32;42;74;24;3;0;77;527;;25,0;128,0;0,0;1,0;1,0
2020-03-12;Trentino-Alto Adige;43;5;48;54;102;28;4;1;107;593;;30,0;66,0;1,0;1,0;1,0
2020-03-13;Trentino-Alto Adige;58;6;64;93;157;55;4;2;163;846;;56,0;253,0;1,0;0,0;1,0
2020-03-14;Trentino-Alto Adige;68;12;80;119;199;42;5;2;206;1006;;43,0;160,0;0,0;1,0;6,0
2020-03-15;Trentino-Alto Adige;73;19;92;275;367;168;5;6;378;1006;;172,0;0,0;4,0;0,0;7,0
2020-03-16;Trentino-Alto Adige;73;19;92;275;367;0;5;6;378;1006;;0,0;0,0;0,0;0,0;0,0
2020-03-17;Trentino-Alto Adige;107;22;129;239;368;1;10;7;385;1727;;7,0;721,0;1,0;5,0;3,0
2020-03-18;Trentino-Alto Adige;141;22;163;273;436;68;12;7;455;2187;;70,0;460,0;0,0;2,0;0,0
2020-03-19;Trentino-Alto Adige;169;30;199;292;491;55;20;12;523;2203;;68,0;16,0;5,0;8,0;8,0
2020-03-20;Trentino-Alto Adige;198;34;232;368;600;109;29;13;642;2656;;119,0;453,0;1,0;9,0;4,0
2020-03-21;Trentino-Alto Adige;233;39;272;448;720;120;34;28;782;2656;;140,0;0,0;15,0;5,0;5,0
2020-03-22;Trentino-Alto Adige;235;46;281;604;885;165;34;35;954;3050;;172,0;394,0;7,0;0,0;7,0
2020-03-23;Trentino-Alto Adige;249;46;295;619;914;29;68;41;1023;3150;;69,0;100,0;6,0;34,0;0,0
2020-03-24;Trentino-Alto Adige;308;49;357;618;975;61;79;56;1110;3712;;87,0;562,0;15,0;11,0;3,0
2020-03-25;Trentino-Alto Adige;308;65;373;685;1058;83;90;74;1222;4114;;112,0;402,0;18,0;11,0;16,0
2020-03-26;Trentino-Alto Adige;300;66;366;728;1094;36;117;86;1297;4600;;75,0;486,0;12,0;27,0;1,0
2020-03-27;Trentino-Alto Adige;341;66;407;757;1164;70;125;102;1391;4923;;94,0;323,0;16,0;8,0;0,0
2020-03-28;Trentino-Alto Adige;351;72;423;811;1234;70;151;120;1505;5561;;114,0;638,0;18,0;26,0;6,0
2020-03-29;Trentino-Alto Adige;356;75;431;862;1293;59;172;129;1594;5950;;89,0;389,0;9,0;21,0;3,0
2020-03-30;Trentino-Alto Adige;353;78;431;926;1357;64;178;147;1682;6377;;88,0;427,0;18,0;6,0;3,0
2020-03-31;Trentino-Alto Adige;354;80;434;955;1389;32;193;164;1746;6973;;64,0;596,0;17,0;15,0;2,0
2020-04-01;Trentino-Alto Adige;345;76;421;1062;1483;94;214;173;1870;7675;;124,0;702,0;9,0;21,0;-4,0
2020-04-02;Trentino-Alto Adige;339;78;417;1170;1587;104;229;187;2003;8496;;133,0;821,0;14,0;15,0;2,0
2020-04-03;Trentino-Alto Adige;343;80;423;1236;1659;72;246;204;2109;8993;;106,0;497,0;17,0;17,0;2,0
2020-04-04;Trentino-Alto Adige;353;81;434;1319;1753;94;257;210;2220;9863;;111,0;870,0;6,0;11,0;1,0
2020-04-05;Trentino-Alto Adige;352;80;432;1363;1795;42;273;217;2285;10476;;65,0;613,0;7,0;16,0;-1,0
2020-04-06;Trentino-Alto Adige;354;79;433;1405;1838;43;280;230;2348;11130;;63,0;654,0;13,0;7,0;-1,0
2020-04-07;Trentino-Alto Adige;360;78;438;1452;1890;52;342;244;2476;12030;;128,0;900,0;14,0;62,0;-1,0
2020-04-08;Trentino-Alto Adige;354;77;431;1509;1940;50;407;255;2602;13258;;126,0;1228,0;11,0;65,0;-1,0
2020-04-09;Trentino-Alto Adige;345;69;414;1564;1978;38;462;268;2708;14338;;106,0;1080,0;13,0;55,0;-8,0
2020-04-10;Trentino-Alto Adige;335;70;405;1589;1994;16;547;275;2816;14981;;108,0;643,0;7,0;85,0;1,0
2020-04-11;Trentino-Alto Adige;335;62;397;1667;2064;70;622;284;2970;16646;;154,0;1665,0;9,0;75,0;-8,0
2020-04-12;Trentino-Alto Adige;322;61;383;1699;2082;18;678;293;3053;17797;;83,0;1151,0;9,0;56,0;-1,0
2020-04-13;Trentino-Alto Adige;326;56;382;1698;2080;-2;746;300;3126;18586;;73,0;789,0;7,0;68,0;-5,0
2020-04-14;Trentino-Alto Adige;325;54;379;1703;2082;2;749;310;3141;18774;;15,0;188,0;10,0;3,0;-2,0
2020-04-15;Trentino-Alto Adige;312;48;360;1744;2104;22;798;318;3220;19535;;79,0;761,0;8,0;49,0;-6,0
2020-04-16;Trentino-Alto Adige;296;43;339;1748;2087;-17;885;322;3294;20773;;74,0;1238,0;4,0;87,0;-5,0
2020-04-17;Trentino-Alto Adige;286;44;330;1660;1990;-97;1044;342;3376;21921;;82,0;1148,0;20,0;159,0;1,0
2020-04-18;Trentino-Alto Adige;276;42;318;1667;1985;-5;1098;348;3431;23147;;55,0;1226,0;6,0;54,0;-2,0
2020-04-19;Trentino-Alto Adige;278;41;319;1652;1971;-14;1201;360;3532;24388;16685,0;101,0;1241,0;12,0;103,0;-1,0
2020-04-20;Trentino-Alto Adige;272;40;312;1617;1929;-42;1295;366;3590;26211;17347,0;58,0;1823,0;6,0;94,0;-1,0
2020-04-21;Trentino-Alto Adige;254;38;292;1617;1909;-20;1329;376;3614;26610;17705,0;24,0;399,0;10,0;34,0;-2,0
2020-04-22;Trentino-Alto Adige;245;34;279;1595;1874;-35;1391;381;3646;26674;17672,0;32,0;64,0;5,0;62,0;-4,0
2020-04-23;Trentino-Alto Adige;234;29;263;1608;1871;-3;1474;382;3727;28240;18656,0;81,0;1566,0;1,0;83,0;-5,0
2020-04-24;Trentino-Alto Adige;224;28;252;1575;1827;-44;1560;389;3776;29779;19250,0;49,0;1539,0;7,0;86,0;-1,0
2020-04-25;Trentino-Alto Adige;202;27;229;1515;1744;-83;1694;400;3838;30661;19394,0;62,0;882,0;11,0;134,0;-1,0
2020-04-26;Trentino-Alto Adige;199;24;223;1459;1682;-62;1807;405;3894;32142;19902,0;56,0;1481,0;5,0;113,0;-3,0
2020-04-27;Trentino-Alto Adige;201;23;224;1483;1707;25;1881;407;3995;33152;20199,0;101,0;1010,0;2,0;74,0;-1,0
2020-04-28;Trentino-Alto Adige;182;22;204;1361;1565;-142;2048;412;4025;33839;20539,0;30,0;687,0;5,0;167,0;-1,0
2020-04-29;Trentino-Alto Adige;165;22;187;1276;1463;-102;2190;416;4069;35008;20944,0;44,0;1169,0;4,0;142,0;0,0
2020-04-30;Trentino-Alto Adige;158;21;179;1191;1370;-93;2328;418;4116;36534;21622,0;47,0;1526,0;2,0;138,0;-1,0
2020-05-01;Trentino-Alto Adige;146;19;165;1128;1293;-77;2416;423;4132;37838;22602,0;16,0;1304,0;5,0;88,0;-2,0
2020-05-02;Trentino-Alto Adige;138;19;157;1125;1282;-11;2474;425;4181;39579;23380,0;49,0;1741,0;2,0;58,0;0,0
2020-05-03;Trentino-Alto Adige;136;17;153;1094;1247;-35;2571;429;4247;41095;24085,0;66,0;1516,0;4,0;97,0;-2,0
2020-05-04;Trentino-Alto Adige;135;17;152;1013;1165;-82;2663;430;4258;42061;24500,0;11,0;966,0;1,0;92,0;0,0
2020-05-05;Trentino-Alto Adige;126;15;141;900;1041;-124;2787;433;4261;42870;25137,0;3,0;809,0;3,0;124,0;-2,0
2020-05-06;Trentino-Alto Adige;116;13;129;853;982;-59;2861;437;4280;44719;26161,0;19,0;1849,0;4,0;74,0;-2,0
2020-05-07;Trentino-Alto Adige;99;11;110;800;910;-72;2935;438;4283;46500;28486,0;3,0;1781,0;1,0;74,0;-2,0
2020-05-08;Trentino-Alto Adige;94;11;105;767;872;-38;2975;438;4285;48220;29188,0;2,0;1720,0;0,0;40,0;0,0
2020-05-09;Trentino-Alto Adige;87;10;97;733;830;-42;3024;438;4292;50278;30354,0;7,0;2058,0;0,0;49,0;-1,0
2020-05-10;Trentino-Alto Adige;82;10;92;694;786;-44;3068;441;4295;52039;30808,0;3,0;1761,0;3,0;44,0;0,0
2020-02-24;Piemonte;2;0;2;1;3;0;0;0;3;141;;3,0;141,0;0,0;0,0;0,0
2020-02-25;Piemonte;2;0;2;1;3;0;0;0;3;141;;0,0;0,0;0,0;0,0;0,0
2020-02-26;Piemonte;2;0;2;1;3;0;0;0;3;156;;0,0;15,0;0,0;0,0;0,0
2020-02-27;Piemonte;2;0;2;0;2;-1;0;0;2;156;;-1,0;0,0;0,0;0,0;0,0
2020-02-28;Piemonte;7;0;7;4;11;9;0;0;11;227;;9,0;71,0;0,0;0,0;0,0
2020-02-29;Piemonte;7;0;7;4;11;0;0;0;11;308;;0,0;81,0;0,0;0,0;0,0
2020-03-01;Piemonte;11;2;13;36;49;38;0;0;49;362;;38,0;54,0;0,0;0,0;2,0
2020-03-02;Piemonte;12;2;14;37;51;2;0;0;51;434;;2,0;72,0;0,0;0,0;0,0
2020-03-03;Piemonte;13;3;16;40;56;5;0;0;56;458;;5,0;24,0;0,0;0,0;1,0
2020-03-04;Piemonte;26;13;39;43;82;26;0;0;82;543;;26,0;85,0;0,0;0,0;10,0
2020-03-05;Piemonte;43;17;60;46;106;24;0;2;108;543;;26,0;0,0;2,0;0,0;4,0
2020-03-06;Piemonte;57;30;87;52;139;33;0;4;143;793;;35,0;250,0;2,0;0,0;13,0
2020-03-07;Piemonte;110;38;148;54;202;63;0;5;207;1046;;64,0;253,0;1,0;0,0;8,0
2020-03-08;Piemonte;245;45;290;65;355;153;0;5;360;1636;;153,0;590,0;0,0;0,0;7,0
2020-03-09;Piemonte;222;50;272;65;337;-18;0;13;350;1681;;-10,0;45,0;8,0;0,0;5,0
2020-03-10;Piemonte;306;66;372;64;436;99;0;17;453;2374;;103,0;693,0;4,0;0,0;16,0
2020-03-11;Piemonte;319;75;394;86;480;44;0;21;501;2431;;48,0;57,0;4,0;0,0;9,0
2020-03-12;Piemonte;368;97;465;89;554;74;0;26;580;2879;;79,0;448,0;5,0;0,0;22,0
2020-03-13;Piemonte;556;135;691;103;794;240;0;46;840;3105;;260,0;226,0;20,0;0,0;38,0
2020-03-14;Piemonte;538;150;688;126;814;20;0;59;873;3680;;33,0;575,0;13,0;0,0;15,0
2020-03-15;Piemonte;726;171;897;133;1030;216;0;81;1111;4375;;238,0;695,0;22,0;0,0;21,0
2020-03-16;Piemonte;1045;186;1231;174;1405;375;0;111;1516;5588;;405,0;1213,0;30,0;0,0;15,0
2020-03-17;Piemonte;1378;206;1584;180;1764;359;0;133;1897;6543;;381,0;955,0;22,0;0,0;20,0
2020-03-18;Piemonte;1780;227;2007;180;2187;423;0;154;2341;7516;;444,0;973,0;21,0;0,0;21,0
2020-03-19;Piemonte;2279;257;2536;218;2754;567;3;175;2932;8853;;591,0;1337,0;21,0;3,0;30,0
2020-03-20;Piemonte;1541;280;1821;1423;3244;490;8;209;3461;9975;;529,0;1122,0;34,0;5,0;23,0
2020-03-21;Piemonte;1976;301;2277;1229;3506;262;8;238;3752;10701;;291,0;726,0;29,0;0,0;21,0
2020-03-22;Piemonte;2118;308;2426;1701;4127;621;10;283;4420;12701;;668,0;2000,0;45,0;2,0;7,0
2020-03-23;Piemonte;2194;343;2537;1992;4529;402;17;315;4861;13560;;441,0;859,0;32,0;7,0;35,0
2020-03-24;Piemonte;2404;360;2764;2360;5124;595;17;374;5515;15469;;654,0;1909,0;59,0;0,0;17,0
2020-03-25;Piemonte;2544;381;2925;2631;5556;432;19;449;6024;16655;;509,0;1186,0;75,0;2,0;21,0
2020-03-26;Piemonte;2633;408;3041;2909;5950;394;135;449;6534;18054;;510,0;1399,0;0,0;116,0;27,0
2020-03-27;Piemonte;2852;431;3283;3064;6347;397;176;569;7092;19705;;558,0;1651,0;120,0;41,0;23,0
2020-03-28;Piemonte;3094;439;3533;3318;6851;504;203;617;7671;21511;;579,0;1806,0;48,0;27,0;8,0
2020-03-29;Piemonte;2985;443;3428;3840;7268;417;254;684;8206;24058;;535,0;2547,0;67,0;51,0;4,0
2020-03-30;Piemonte;2985;452;3437;4218;7655;387;308;749;8712;25478;;506,0;1420,0;65,0;54,0;9,0
2020-03-31;Piemonte;3174;452;3626;4456;8082;427;365;854;9301;27658;;589,0;2180,0;105,0;57,0;0,0
2020-04-01;Piemonte;3146;453;3599;4871;8470;388;439;886;9795;30060;;494,0;2402,0;32,0;74,0;1,0
2020-04-02;Piemonte;3341;453;3794;5005;8799;329;571;983;10353;32100;;558,0;2040,0;97,0;132,0;0,0
2020-04-03;Piemonte;3300;452;3752;5378;9130;331;723;1043;10896;34281;;543,0;2181,0;60,0;152,0;-1,0
2020-04-04;Piemonte;3441;450;3891;5802;9693;563;888;1128;11709;37181;;813,0;2900,0;85,0;165,0;-2,0
2020-04-05;Piemonte;3472;444;3916;6261;10177;484;1017;1168;12362;38539;;653,0;1358,0;40,0;129,0;-6,0
2020-04-06;Piemonte;3484;438;3922;6623;10545;368;1128;1251;12924;41123;;562,0;2584,0;83,0;111,0;-6,0
2020-04-07;Piemonte;3553;432;3985;6719;10704;159;1320;1319;13343;44121;;419,0;2998,0;68,0;192,0;-6,0
2020-04-08;Piemonte;3493;423;3916;7073;10989;285;1516;1378;13883;48495;;540,0;4374,0;59,0;196,0;-9,0
2020-04-09;Piemonte;3514;412;3926;7410;11336;347;1732;1454;14522;52807;;639,0;4312,0;76,0;216,0;-11,0
2020-04-10;Piemonte;3497;394;3891;7685;11576;240;1904;1532;15012;57457;;490,0;4650,0;78,0;172,0;-18,0
2020-04-11;Piemonte;3435;384;3819;8351;12170;594;2205;1633;16008;62577;;996,0;5120,0;101,0;301,0;-10,0
2020-04-12;Piemonte;3429;381;3810;8695;12505;335;2426;1729;16660;66555;;652,0;3978,0;96,0;221,0;-3,0
2020-04-13;Piemonte;3344;379;3723;9042;12765;260;2543;1826;17134;69170;;474,0;2615,0;97,0;117,0;-2,0
2020-04-14;Piemonte;3395;367;3762;9293;13055;290;2708;1927;17690;71678;;556,0;2508,0;101,0;165,0;-12,0
2020-04-15;Piemonte;3338;366;3704;9491;13195;140;3019;2015;18229;75664;;539,0;3986,0;88,0;311,0;-1,0
2020-04-16;Piemonte;3418;346;3764;10019;13783;588;3231;2094;19108;80708;;879,0;5044,0;79,0;212,0;-20,0
2020-04-17;Piemonte;3266;333;3599;10399;13998;215;3634;2171;19803;86714;;695,0;6006,0;77,0;403,0;-13,0
2020-04-18;Piemonte;3271;323;3594;10629;14223;225;3989;2252;20464;91844;;661,0;5130,0;81,0;355,0;-10,0
2020-04-19;Piemonte;3201;305;3506;10964;14470;247;4256;2331;21057;96569;71644,0;593,0;4725,0;79,0;267,0;-18,0
2020-04-20;Piemonte;3299;301;3600;10957;14557;87;4383;2409;21349;99669;73192,0;292,0;3100,0;78,0;127,0;-4,0
2020-04-21;Piemonte;3116;293;3409;11402;14811;254;4659;2485;21955;105434;76406,0;606,0;5765,0;76,0;276,0;-8,0
2020-04-22;Piemonte;3213;273;3486;11636;15122;311;5058;2559;22739;111513;81176,0;784,0;6079,0;74,0;399,0;-20,0
2020-04-23;Piemonte;3039;261;3300;11852;15152;30;5358;2630;23140;117970;84648,0;401,0;6457,0;71,0;300,0;-12,0
2020-04-24;Piemonte;2918;257;3175;12216;15391;239;5732;2699;23822;125300;89392,0;682,0;7330,0;69,0;374,0;-4,0
2020-04-25;Piemonte;2937;238;3175;12327;15502;111;6157;2767;24426;131107;93325,0;604,0;5807,0;68,0;425,0;-19,0
2020-04-26;Piemonte;2866;214;3080;12439;15519;17;6478;2823;24820;135142;96977,0;394,0;4035,0;56,0;321,0;-24,0
2020-04-27;Piemonte;2830;214;3044;12464;15508;-11;6712;2878;25098;139348;99144,0;278,0;4206,0;55,0;234,0;0,0
2020-04-28;Piemonte;2701;202;2903;12603;15506;-2;7008;2936;25450;144531;102514,0;352,0;5183,0;58,0;296,0;-12,0
2020-04-29;Piemonte;2637;202;2839;12682;15521;15;7337;3003;25861;151266;106179,0;411,0;6735,0;67,0;329,0;0,0
2020-04-30;Piemonte;2621;199;2820;12673;15493;-28;7730;3066;26289;156534;110157,0;428,0;5268,0;63,0;393,0;-3,0
2020-05-01;Piemonte;2503;181;2684;12878;15562;69;8025;3097;26684;162568;114786,0;395,0;6034,0;31,0;295,0;-18,0
2020-05-02;Piemonte;2550;178;2728;12991;15719;157;8334;3126;27179;168479;118814,0;495,0;5911,0;29,0;309,0;-3,0
2020-05-03;Piemonte;2496;169;2665;12973;15638;-81;8640;3152;27430;172208;121176,0;251,0;3729,0;26,0;306,0;-9,0
2020-05-04;Piemonte;2391;161;2552;13010;15562;-76;8874;3186;27622;176078;123801,0;192,0;3870,0;34,0;234,0;-8,0
2020-05-05;Piemonte;2307;155;2462;12861;15323;-239;9235;3216;27774;181316;126685,0;152,0;5238,0;30,0;361,0;-6,0
2020-05-06;Piemonte;2147;150;2297;12561;14858;-465;9834;3247;27939;188057;131269,0;165,0;6741,0;31,0;599,0;-5,0
2020-05-07;Piemonte;2147;150;2297;12172;14469;-389;10384;3282;28135;194584;134567,0;196,0;6527,0;35,0;550,0;0,0
2020-05-08;Piemonte;2013;140;2153;11954;14107;-362;10956;3305;28368;201183;138830,0;233,0;6599,0;23,0;572,0;-10,0
2020-05-09;Piemonte;2010;143;2153;11781;13934;-173;11284;3331;28549;205800;141515,0;181,0;4617,0;26,0;328,0;3,0
2020-05-10;Piemonte;2024;137;2161;11489;13650;-284;11648;3367;28665;210370;145131,0;116,0;4570,0;36,0;364,0;-6,0
2020-02-24;Puglia;0;0;0;0;0;0;0;0;0;0;;0,0;0,0;0,0;0,0;0,0
2020-02-25;Puglia;0;0;0;0;0;0;0;0;0;0;;0,0;0,0;0,0;0,0;0,0
2020-02-26;Puglia;0;0;0;0;0;0;0;0;0;0;;0,0;0,0;0,0;0,0;0,0
2020-02-27;Puglia;1;0;1;0;1;1;0;0;1;0;;1,0;0,0;0,0;0,0;0,0
2020-02-28;Puglia;1;0;1;2;3;2;0;0;3;242;;2,0;242,0;0,0;0,0;0,0
2020-02-29;Puglia;1;0;1;2;3;0;0;0;3;252;;0,0;10,0;0,0;0,0;0,0
2020-03-01;Puglia;1;0;1;2;3;0;0;0;3;262;;0,0;10,0;0,0;0,0;0,0
2020-03-02;Puglia;2;0;2;2;4;1;0;0;4;278;;1,0;16,0;0,0;0,0;0,0
2020-03-03;Puglia;2;0;2;4;6;2;0;0;6;298;;2,0;20,0;0,0;0,0;0,0
2020-03-04;Puglia;4;0;4;3;7;1;1;1;9;322;;3,0;24,0;1,0;1,0;0,0
2020-03-05;Puglia;5;1;6;6;12;5;1;1;14;359;;5,0;37,0;0,0;0,0;1,0
2020-03-06;Puglia;5;1;6;9;15;3;1;1;17;395;;3,0;36,0;0,0;0,0;0,0
2020-03-07;Puglia;9;2;11;12;23;8;1;2;26;395;;9,0;0,0;1,0;0,0;1,0
2020-03-08;Puglia;17;3;20;16;36;13;1;3;40;627;;14,0;232,0;1,0;0,0;1,0
2020-03-09;Puglia;20;6;26;20;46;10;1;3;50;685;;10,0;58,0;0,0;0,0;3,0
2020-03-10;Puglia;28;6;34;21;55;9;1;3;59;747;;9,0;62,0;0,0;0,0;0,0
2020-03-11;Puglia;38;4;42;29;71;16;1;5;77;909;;18,0;162,0;2,0;0,0;-2,0
2020-03-12;Puglia;58;2;60;38;98;27;1;5;104;1269;;27,0;360,0;0,0;0,0;-2,0
2020-03-13;Puglia;77;2;79;42;121;23;3;5;129;1449;;25,0;180,0;0,0;2,0;0,0
2020-03-14;Puglia;91;6;97;59;156;35;2;8;166;1681;;37,0;232,0;3,0;-1,0;4,0
2020-03-15;Puglia;116;6;122;90;212;56;2;16;230;2017;;64,0;336,0;8,0;0,0;0,0
2020-03-16;Puglia;116;6;122;90;212;0;2;16;230;2017;;0,0;0,0;0,0;0,0;0,0
2020-03-17;Puglia;155;14;169;151;320;108;2;18;340;3077;;110,0;1060,0;2,0;0,0;8,0
2020-03-18;Puglia;156;30;186;176;362;42;2;19;383;3433;;43,0;356,0;1,0;0,0;16,0
2020-03-19;Puglia;173;31;204;245;449;87;4;25;478;4046;;95,0;613,0;6,0;2,0;1,0
2020-03-20;Puglia;191;31;222;329;551;102;4;26;581;4789;;103,0;743,0;1,0;0,0;0,0
2020-03-21;Puglia;209;33;242;400;642;91;4;29;675;5617;;94,0;828,0;3,0;0,0;2,0
2020-03-22;Puglia;252;37;289;459;748;106;7;31;786;6160;;111,0;543,0;2,0;3,0;4,0
2020-03-23;Puglia;285;45;330;532;862;114;7;37;906;6761;;120,0;601,0;6,0;0,0;8,0
2020-03-24;Puglia;317;57;374;566;940;78;21;44;1005;7345;;99,0;584,0;7,0;14,0;12,0
2020-03-25;Puglia;349;64;413;610;1023;83;22;48;1093;8223;;88,0;878,0;4,0;1,0;7,0
2020-03-26;Puglia;480;76;556;539;1095;72;22;65;1182;9191;;89,0;968,0;17,0;0,0;12,0
2020-03-27;Puglia;530;82;612;624;1236;141;29;69;1334;10233;;152,0;1042,0;4,0;7,0;6,0
2020-03-28;Puglia;563;98;661;697;1358;122;29;71;1458;11500;;124,0;1267,0;2,0;0,0;16,0
2020-03-29;Puglia;559;99;658;774;1432;74;31;86;1549;12361;;91,0;861,0;15,0;2,0;1,0
2020-03-30;Puglia;590;106;696;889;1585;153;36;91;1712;13117;;163,0;756,0;5,0;5,0;7,0
2020-03-31;Puglia;609;105;714;940;1654;69;39;110;1803;14073;;91,0;956,0;19,0;3,0;-1,0
2020-04-01;Puglia;637;107;744;1012;1756;102;61;129;1946;15209;;143,0;1136,0;19,0;22,0;2,0
2020-04-02;Puglia;645;118;763;1101;1864;108;69;144;2077;16554;;131,0;1345,0;15,0;8,0;11,0
2020-04-03;Puglia;648;123;771;1178;1949;85;69;164;2182;17924;;105,0;1370,0;20,0;0,0;5,0
2020-04-04;Puglia;627;153;780;1193;1973;24;94;173;2240;18977;;58,0;1053,0;9,0;25,0;30,0
2020-04-05;Puglia;574;159;733;1289;2022;49;113;182;2317;20080;;77,0;1103,0;9,0;19,0;6,0
2020-04-06;Puglia;625;97;722;1393;2115;93;134;195;2444;22059;;127,0;1979,0;13,0;21,0;-62,0
2020-04-07;Puglia;615;93;708;1429;2137;22;168;209;2514;23149;;70,0;1090,0;14,0;34,0;-4,0
2020-04-08;Puglia;639;90;729;1509;2238;101;177;219;2634;24493;;120,0;1344,0;10,0;9,0;-3,0
2020-04-09;Puglia;630;86;716;1585;2301;63;190;225;2716;26088;;82,0;1595,0;6,0;13,0;-4,0
2020-04-10;Puglia;631;80;711;1625;2336;35;235;238;2809;27812;;93,0;1724,0;13,0;45,0;-6,0
2020-04-11;Puglia;627;73;700;1702;2402;66;249;253;2904;29463;;95,0;1651,0;15,0;14,0;-7,0
2020-04-12;Puglia;609;71;680;1772;2452;50;277;260;2989;30973;;85,0;1510,0;7,0;28,0;-2,0
2020-04-13;Puglia;600;71;671;1841;2512;60;286;267;3065;31922;;76,0;949,0;7,0;9,0;0,0
2020-04-14;Puglia;611;62;673;1879;2552;40;288;278;3118;33071;;53,0;1149,0;11,0;2,0;-9,0
2020-04-15;Puglia;592;73;665;1908;2573;21;323;288;3184;34518;;66,0;1447,0;10,0;35,0;11,0
2020-04-16;Puglia;603;58;661;1964;2625;52;334;299;3258;36158;;74,0;1640,0;11,0;11,0;-15,0
2020-04-17;Puglia;590;62;652;2004;2656;31;364;307;3327;38278;;69,0;2120,0;8,0;30,0;4,0
2020-04-18;Puglia;594;60;654;2040;2694;38;401;314;3409;40423;;82,0;2145,0;7,0;37,0;-2,0
2020-04-19;Puglia;590;60;650;2136;2786;92;427;316;3529;42598;41580,0;120,0;2175,0;2,0;26,0;0,0
2020-04-20;Puglia;584;66;650;2160;2810;24;431;326;3567;44189;43119,0;38,0;1591,0;10,0;4,0;6,0
2020-04-21;Puglia;569;65;634;2178;2812;2;459;351;3622;45984;44760,0;55,0;1795,0;25,0;28,0;-1,0
2020-04-22;Puglia;564;60;624;2250;2874;62;494;362;3730;48342;46925,0;108,0;2358,0;11,0;35,0;-5,0
2020-04-23;Puglia;536;55;591;2345;2936;62;531;372;3839;50410;49403,0;109,0;2068,0;10,0;37,0;-5,0
2020-04-24;Puglia;496;51;547;2386;2933;-3;565;383;3881;52472;51517,0;42,0;2062,0;11,0;34,0;-4,0
2020-04-25;Puglia;469;48;517;2402;2919;-14;602;391;3912;54628;53500,0;31,0;2156,0;8,0;37,0;-3,0
2020-04-26;Puglia;464;48;512;2425;2937;18;612;399;3948;55992;55397,0;36,0;1364,0;8,0;10,0;0,0
2020-04-27;Puglia;449;51;500;2412;2912;-25;641;405;3958;56976;55897,0;10,0;984,0;6,0;29,0;3,0
2020-04-28;Puglia;448;51;499;2420;2919;7;654;407;3980;58496;57574,0;22,0;1520,0;2,0;13,0;0,0
2020-04-29;Puglia;449;47;496;2431;2927;8;692;410;4029;60334;59801,0;49,0;1838,0;3,0;38,0;-4,0
2020-04-30;Puglia;439;42;481;2468;2949;22;708;415;4072;62460;61439,0;43,0;2126,0;5,0;16,0;-5,0
2020-05-01;Puglia;428;39;467;2480;2947;-2;731;421;4099;64292;62702,0;27,0;1832,0;6,0;23,0;-3,0
2020-05-02;Puglia;416;39;455;2499;2954;7;757;422;4133;65370;63782,0;34,0;1078,0;1,0;26,0;0,0
2020-05-03;Puglia;410;40;450;2505;2955;1;765;424;4144;66443;64781,0;11,0;1073,0;2,0;8,0;1,0
2020-05-04;Puglia;397;39;436;2509;2945;-10;779;429;4153;67167;65789,0;9,0;724,0;5,0;14,0;-1,0
2020-05-05;Puglia;384;39;423;2516;2939;-6;798;433;4170;69128;67238,0;17,0;1961,0;4,0;19,0;0,0
2020-05-06;Puglia;365;36;401;2502;2903;-36;855;438;4196;70944;68760,0;26,0;1816,0;5,0;57,0;-3,0
2020-05-07;Puglia;355;35;390;2410;2800;-103;1004;441;4245;72796;51638,0;49,0;1852,0;3,0;149,0;-1,0
2020-05-08;Puglia;349;33;382;2351;2733;-67;1080;443;4256;74724;53194,0;11,0;1928,0;2,0;76,0;-2,0
2020-05-09;Puglia;344;33;377;2352;2729;-4;1114;443;4286;76643;54181,0;30,0;1919,0;0,0;34,0;0,0
2020-05-10;Puglia;343;34;377;2292;2669;-60;1196;448;4313;78399;54781,0;27,0;1756,0;5,0;82,0;1,0
2020-02-24;Sardegna;0;0;0;0;0;0;0;0;0;1;;0,0;1,0;0,0;0,0;0,0
2020-02-25;Sardegna;0;0;0;0;0;0;0;0;0;1;;0,0;0,0;0,0;0,0;0,0
2020-02-26;Sardegna;0;0;0;0;0;0;0;0;0;1;;0,0;0,0;0,0;0,0;0,0
2020-02-27;Sardegna;0;0;0;0;0;0;0;0;0;1;;0,0;0,0;0,0;0,0;0,0
2020-02-28;Sardegna;0;0;0;0;0;0;0;0;0;1;;0,0;0,0;0,0;0,0;0,0
2020-02-29;Sardegna;0;0;0;0;0;0;0;0;0;1;;0,0;0,0;0,0;0,0;0,0
2020-03-01;Sardegna;0;0;0;0;0;0;0;0;0;29;;0,0;28,0;0,0;0,0;0,0
2020-03-02;Sardegna;0;0;0;0;0;0;0;0;0;29;;0,0;0,0;0,0;0,0;0,0
2020-03-03;Sardegna;1;0;1;0;1;1;0;0;1;29;;1,0;0,0;0,0;0,0;0,0
2020-03-04;Sardegna;1;0;1;1;2;1;0;0;2;42;;1,0;13,0;0,0;0,0;0,0
2020-03-05;Sardegna;2;0;2;0;2;0;0;0;2;50;;0,0;8,0;0,0;0,0;0,0
2020-03-06;Sardegna;2;0;2;3;5;3;0;0;5;99;;3,0;49,0;0,0;0,0;0,0
2020-03-07;Sardegna;2;0;2;3;5;0;0;0;5;99;;0,0;0,0;0,0;0,0;0,0
2020-03-08;Sardegna;5;0;5;6;11;6;0;0;11;149;;6,0;50,0;0,0;0,0;0,0
2020-03-09;Sardegna;8;0;8;11;19;8;0;0;19;185;;8,0;36,0;0,0;0,0;0,0
2020-03-10;Sardegna;9;0;9;11;20;1;0;0;20;204;;1,0;19,0;0,0;0,0;0,0
2020-03-11;Sardegna;10;0;10;27;37;17;0;0;37;283;;17,0;79,0;0,0;0,0;0,0
2020-03-12;Sardegna;12;0;12;27;39;2;0;0;39;302;;2,0;19,0;0,0;0,0;0,0
2020-03-13;Sardegna;12;0;12;31;43;4;0;0;43;504;;4,0;202,0;0,0;0,0;0,0
2020-03-14;Sardegna;14;0;14;33;47;4;0;0;47;530;;4,0;26,0;0,0;0,0;0,0
2020-03-15;Sardegna;16;0;16;59;75;28;0;2;77;613;;30,0;83,0;2,0;0,0;0,0
2020-03-16;Sardegna;39;0;39;66;105;30;0;2;107;797;;30,0;184,0;0,0;0,0;0,0
2020-03-17;Sardegna;36;4;40;75;115;10;0;2;117;1003;;10,0;206,0;0,0;0,0;4,0
2020-03-18;Sardegna;42;7;49;83;132;17;0;2;134;1135;;17,0;132,0;0,0;0,0;3,0
2020-03-19;Sardegna;43;9;52;152;204;72;0;2;206;1334;;72,0;199,0;0,0;0,0;2,0
2020-03-20;Sardegna;56;15;71;217;288;84;3;2;293;1912;;87,0;578,0;0,0;3,0;6,0
2020-03-21;Sardegna;65;16;81;240;321;33;5;4;330;2297;;37,0;385,0;2,0;2,0;1,0
2020-03-22;Sardegna;67;16;83;244;327;6;5;7;339;2402;;9,0;105,0;3,0;0,0;0,0
2020-03-23;Sardegna;76;18;94;249;343;16;5;11;359;2568;;20,0;166,0;4,0;0,0;2,0
2020-03-24;Sardegna;80;19;99;296;395;52;11;15;421;2859;;62,0;291,0;4,0;6,0;1,0
2020-03-25;Sardegna;82;19;101;311;412;17;12;18;442;3019;;21,0;160,0;3,0;1,0;0,0
2020-03-26;Sardegna;92;20;112;350;462;50;13;19;494;3461;;52,0;442,0;1,0;1,0;1,0
2020-03-27;Sardegna;93;19;112;384;496;34;13;21;530;3801;;36,0;340,0;2,0;0,0;-1,0
2020-03-28;Sardegna;95;22;117;452;569;73;29;26;624;4225;;94,0;424,0;5,0;16,0;3,0
2020-03-29;Sardegna;105;23;128;454;582;13;29;27;638;4598;;14,0;373,0;1,0;0,0;1,0
2020-03-30;Sardegna;113;24;137;485;622;40;32;28;682;4993;;44,0;395,0;1,0;3,0;1,0
2020-03-31;Sardegna;113;28;141;516;657;35;34;31;722;5257;;40,0;264,0;3,0;2,0;4,0
2020-04-01;Sardegna;119;27;146;529;675;18;36;34;745;5501;;23,0;244,0;3,0;2,0;-1,0
2020-04-02;Sardegna;117;24;141;577;718;43;36;40;794;5970;;49,0;469,0;6,0;0,0;-3,0
2020-04-03;Sardegna;122;24;146;598;744;26;40;41;825;6478;;31,0;508,0;1,0;4,0;0,0
2020-04-04;Sardegna;123;24;147;642;789;45;44;41;874;6789;;49,0;311,0;0,0;4,0;0,0
2020-04-05;Sardegna;126;25;151;664;815;26;49;43;907;7157;;33,0;368,0;2,0;5,0;1,0
2020-04-06;Sardegna;123;26;149;670;819;4;56;47;922;7521;;15,0;364,0;4,0;7,0;1,0
2020-04-07;Sardegna;122;26;148;673;821;2;62;52;935;7680;;13,0;159,0;5,0;6,0;0,0
2020-04-08;Sardegna;112;31;143;697;840;19;76;59;975;8493;;40,0;813,0;7,0;14,0;5,0
2020-04-09;Sardegna;106;25;131;745;876;36;86;64;1026;8918;;51,0;425,0;5,0;10,0;-6,0
2020-04-10;Sardegna;107;26;133;743;876;0;118;69;1063;9444;;37,0;526,0;5,0;32,0;1,0
2020-04-11;Sardegna;113;24;137;751;888;12;130;73;1091;10120;;28,0;676,0;4,0;12,0;-2,0
2020-04-12;Sardegna;109;26;135;768;903;15;137;73;1113;10663;;22,0;543,0;0,0;7,0;2,0
2020-04-13;Sardegna;107;27;134;780;914;11;139;75;1128;11010;;15,0;347,0;2,0;2,0;1,0
2020-04-14;Sardegna;107;24;131;769;900;-14;158;80;1138;11893;;10,0;883,0;5,0;19,0;-3,0
2020-04-15;Sardegna;107;26;133;737;870;-30;208;83;1161;12395;;23,0;502,0;3,0;50,0;2,0
2020-04-16;Sardegna;109;24;133;732;865;-5;214;85;1164;12796;;3,0;401,0;2,0;6,0;-2,0
2020-04-17;Sardegna;113;23;136;736;872;7;220;86;1178;13304;;14,0;508,0;1,0;6,0;-1,0
2020-04-18;Sardegna;112;23;135;746;881;9;231;86;1198;14087;;20,0;783,0;0,0;11,0;0,0
2020-04-19;Sardegna;117;22;139;725;864;-17;265;86;1215;14859;13760,0;17,0;772,0;0,0;34,0;-1,0
2020-04-20;Sardegna;115;21;136;718;854;-10;288;86;1228;15328;14160,0;13,0;469,0;0,0;23,0;-1,0
2020-04-21;Sardegna;112;21;133;704;837;-17;306;93;1236;15886;14526,0;8,0;558,0;7,0;18,0;0,0
2020-04-22;Sardegna;97;20;117;716;833;-4;318;96;1247;16886;15354,0;11,0;1000,0;3,0;12,0;-1,0
2020-04-23;Sardegna;90;20;110;707;817;-16;339;98;1254;17844;16094,0;7,0;958,0;2,0;21,0;0,0
2020-04-24;Sardegna;95;19;114;690;804;-13;351;102;1257;19889;18050,0;3,0;2045,0;4,0;12,0;-1,0
2020-04-25;Sardegna;96;18;114;680;794;-10;374;103;1271;20351;18480,0;14,0;462,0;1,0;23,0;-1,0
2020-04-26;Sardegna;95;20;115;668;783;-11;388;109;1280;21101;19162,0;9,0;750,0;6,0;14,0;2,0
2020-04-27;Sardegna;97;19;116;660;776;-7;398;109;1283;21395;19424,0;3,0;294,0;0,0;10,0;-1,0
2020-04-28;Sardegna;96;18;114;658;772;-4;404;109;1285;22116;20053,0;2,0;721,0;0,0;6,0;-1,0
2020-04-29;Sardegna;87;17;104;657;761;-11;413;116;1290;23299;21071,0;5,0;1183,0;7,0;9,0;-1,0
2020-04-30;Sardegna;87;16;103;641;744;-17;435;116;1295;24754;22358,0;5,0;1455,0;0,0;22,0;-1,0
2020-05-01;Sardegna;84;12;96;648;744;0;452;117;1313;26242;23442,0;18,0;1488,0;1,0;17,0;-4,0
2020-05-02;Sardegna;86;13;99;631;730;-14;466;119;1315;26990;24065,0;2,0;748,0;2,0;14,0;1,0
2020-05-03;Sardegna;92;10;102;587;689;-41;511;119;1319;27737;24662,0;4,0;747,0;0,0;45,0;-3,0
2020-05-04;Sardegna;91;9;100;553;653;-36;545;119;1317;28052;24926,0;-2,0;315,0;0,0;34,0;-1,0
2020-05-05;Sardegna;94;9;103;539;642;-11;557;119;1318;28867;25631,0;1,0;815,0;0,0;12,0;0,0
2020-05-06;Sardegna;91;11;102;521;623;-19;577;119;1319;29966;26598,0;1,0;1099,0;0,0;20,0;2,0
2020-05-07;Sardegna;90;9;99;484;583;-40;622;119;1324;31064;27540,0;5,0;1098,0;0,0;45,0;-2,0
2020-05-08;Sardegna;90;10;100;453;553;-30;658;119;1330;32219;28519,0;6,0;1155,0;0,0;36,0;1,0
2020-05-09;Sardegna;87;11;98;452;550;-3;665;119;1334;33330;29503,0;4,0;1111,0;0,0;7,0;1,0
2020-05-10;Sardegna;83;10;93;422;515;-35;705;120;1340;34046;30086,0;6,0;716,0;1,0;40,0;-1,0
2020-02-24;Sicilia;0;0;0;0;0;0;0;0;0;5;;0,0;5,0;0,0;0,0;0,0
2020-02-25;Sicilia;1;0;1;2;3;3;0;0;3;5;;3,0;0,0;0,0;0,0;0,0
2020-02-26;Sicilia;1;0;1;2;3;0;0;0;3;5;;0,0;0,0;0,0;0,0;0,0
2020-02-27;Sicilia;1;0;1;1;2;-1;2;0;4;5;;1,0;0,0;0,0;2,0;0,0
2020-02-28;Sicilia;1;0;1;1;2;0;2;0;4;5;;0,0;0,0;0,0;0,0;0,0
2020-02-29;Sicilia;1;0;1;1;2;0;2;0;4;6;;0,0;1,0;0,0;0,0;0,0
2020-03-01;Sicilia;1;0;1;6;7;5;2;0;9;291;;5,0;285,0;0,0;0,0;0,0
2020-03-02;Sicilia;2;0;2;3;5;-2;2;0;7;307;;-2,0;16,0;0,0;0,0;0,0
2020-03-03;Sicilia;2;0;2;3;5;0;2;0;7;307;;0,0;0,0;0,0;0,0;0,0
2020-03-04;Sicilia;5;0;5;11;16;11;2;0;18;367;;11,0;60,0;0,0;0,0;0,0
2020-03-05;Sicilia;5;0;5;11;16;0;2;0;18;367;;0,0;0,0;0,0;0,0;0,0
2020-03-06;Sicilia;7;0;7;15;22;6;2;0;24;367;;6,0;0,0;0,0;0,0;0,0
2020-03-07;Sicilia;8;0;8;25;33;11;2;0;35;643;;11,0;276,0;0,0;0,0;0,0
2020-03-08;Sicilia;18;0;18;33;51;18;2;0;53;791;;18,0;148,0;0,0;0,0;0,0
2020-03-09;Sicilia;19;0;19;33;52;1;2;0;54;836;;1,0;45,0;0,0;0,0;0,0
2020-03-10;Sicilia;17;2;19;41;60;8;2;0;62;955;;8,0;119,0;0,0;0,0;2,0
2020-03-11;Sicilia;23;1;24;57;81;21;2;0;83;1194;;21,0;239,0;0,0;0,0;-1,0
2020-03-12;Sicilia;28;5;33;78;111;30;2;2;115;1477;;32,0;283,0;2,0;0,0;4,0
2020-03-13;Sicilia;37;7;44;82;126;15;2;2;130;1950;;15,0;473,0;0,0;0,0;2,0
2020-03-14;Sicilia;42;11;53;97;150;24;4;2;156;2100;;26,0;150,0;0,0;2,0;4,0
2020-03-15;Sicilia;56;15;71;108;179;29;7;2;188;2452;;32,0;352,0;0,0;3,0;4,0
2020-03-16;Sicilia;75;20;95;108;203;24;8;2;213;2653;;25,0;201,0;0,0;1,0;5,0
2020-03-17;Sicilia;86;28;114;112;226;23;8;3;237;2916;;24,0;263,0;1,0;0,0;8,0
2020-03-18;Sicilia;100;29;129;138;267;41;12;3;282;3294;;45,0;378,0;0,0;4,0;1,0
2020-03-19;Sicilia;143;36;179;142;321;54;15;4;340;3961;;58,0;667,0;1,0;3,0;7,0
2020-03-20;Sicilia;168;42;210;169;379;58;25;4;408;4468;;68,0;507,0;0,0;10,0;6,0
2020-03-21;Sicilia;206;48;254;204;458;79;26;6;490;4883;;82,0;415,0;2,0;1,0;6,0
2020-03-22;Sicilia;220;55;275;321;596;138;26;8;630;5580;;140,0;697,0;2,0;0,0;7,0
2020-03-23;Sicilia;250;60;310;371;681;85;27;13;721;6375;;91,0;795,0;5,0;1,0;5,0
2020-03-24;Sicilia;250;60;310;489;799;118;27;20;846;7170;;125,0;795,0;7,0;0,0;0,0
2020-03-25;Sicilia;259;80;339;597;936;137;33;25;994;8312;;148,0;1142,0;5,0;6,0;20,0
2020-03-26;Sicilia;346;68;414;681;1095;159;36;33;1164;9658;;170,0;1346,0;8,0;3,0;-12,0
2020-03-27;Sicilia;425;75;500;658;1158;63;53;39;1250;11079;;86,0;1421,0;6,0;17,0;7,0
2020-03-28;Sicilia;441;71;512;730;1242;84;60;57;1359;13096;;109,0;2017,0;18,0;7,0;-4,0
2020-03-29;Sicilia;451;71;522;808;1330;88;65;65;1460;13814;;101,0;718,0;8,0;5,0;0,0
2020-03-30;Sicilia;484;75;559;849;1408;78;71;76;1555;14758;;95,0;944,0;11,0;6,0;4,0
2020-03-31;Sicilia;503;72;575;917;1492;84;74;81;1647;15634;;92,0;876,0;5,0;3,0;-3,0
2020-04-01;Sicilia;496;72;568;976;1544;52;86;88;1718;16836;;71,0;1202,0;7,0;12,0;0,0
2020-04-02;Sicilia;503;73;576;1030;1606;62;92;93;1791;17833;;73,0;997,0;5,0;6,0;1,0
2020-04-03;Sicilia;535;73;608;1056;1664;58;94;101;1859;18686;;68,0;853,0;8,0;2,0;0,0
2020-04-04;Sicilia;553;74;627;1099;1726;62;95;111;1932;19896;;73,0;1210,0;10,0;1,0;1,0
2020-04-05;Sicilia;556;76;632;1142;1774;48;104;116;1994;21904;;62,0;2008,0;5,0;9,0;2,0
2020-04-06;Sicilia;563;74;637;1178;1815;41;108;123;2046;23464;;52,0;1560,0;7,0;4,0;-2,0
2020-04-07;Sicilia;562;73;635;1224;1859;44;113;125;2097;24857;;51,0;1393,0;2,0;5,0;-1,0
2020-04-08;Sicilia;563;65;628;1265;1893;34;133;133;2159;27438;;62,0;2581,0;8,0;20,0;-8,0
2020-04-09;Sicilia;566;63;629;1313;1942;49;152;138;2232;28742;;73,0;1304,0;5,0;19,0;-2,0
2020-04-10;Sicilia;568;62;630;1337;1967;25;187;148;2302;31156;;70,0;2414,0;10,0;35,0;-1,0
2020-04-11;Sicilia;562;58;620;1381;2001;34;209;154;2364;33787;;62,0;2631,0;6,0;22,0;-4,0
2020-04-12;Sicilia;552;53;605;1425;2030;29;223;163;2416;36098;;52,0;2311,0;9,0;14,0;-5,0
2020-04-13;Sicilia;554;51;605;1445;2050;20;237;171;2458;37311;;42,0;1213,0;8,0;14,0;-2,0
2020-04-14;Sicilia;552;53;605;1466;2071;21;255;175;2501;37877;;43,0;566,0;4,0;18,0;2,0
2020-04-15;Sicilia;541;49;590;1491;2081;10;273;181;2535;39867;;34,0;1990,0;6,0;18,0;-4,0
2020-04-16;Sicilia;525;48;573;1535;2108;27;284;187;2579;42405;;44,0;2538,0;6,0;11,0;-1,0
2020-04-17;Sicilia;521;46;567;1572;2139;31;296;190;2625;45172;;46,0;2767,0;3,0;12,0;-2,0
2020-04-18;Sicilia;526;42;568;1603;2171;32;305;196;2672;47715;;47,0;2543,0;6,0;9,0;-4,0
2020-04-19;Sicilia;522;41;563;1639;2202;31;315;200;2717;49772;49772,0;45,0;2057,0;4,0;10,0;-1,0
2020-04-20;Sicilia;526;39;565;1645;2210;8;346;203;2759;51373;51373,0;42,0;1601,0;3,0;31,0;-2,0
2020-04-21;Sicilia;514;37;551;1708;2259;49;370;206;2835;55093;55093,0;76,0;3720,0;3,0;24,0;-2,0
2020-04-22;Sicilia;500;35;535;1752;2287;28;388;208;2883;58732;58732,0;48,0;3639,0;2,0;18,0;-2,0
2020-04-23;Sicilia;476;34;510;1791;2301;14;412;213;2926;62150;62150,0;43,0;3418,0;5,0;24,0;-1,0
2020-04-24;Sicilia;461;32;493;1827;2320;19;443;218;2981;65165;63626,0;55,0;3015,0;5,0;31,0;-2,0
2020-04-25;Sicilia;452;33;485;1787;2272;-48;524;224;3020;68251;64892,0;39,0;3086,0;6,0;81,0;1,0
2020-04-26;Sicilia;445;33;478;1629;2107;-165;720;228;3055;70104;65689,0;35,0;1853,0;4,0;196,0;0,0
2020-04-27;Sicilia;440;35;475;1648;2123;16;731;231;3085;70650;66749,0;30,0;546,0;3,0;11,0;2,0
2020-04-28;Sicilia;428;34;462;1681;2143;20;745;232;3120;73008;68729,0;35,0;2358,0;1,0;14,0;-1,0
2020-04-29;Sicilia;415;34;449;1696;2145;2;763;232;3140;75360;71301,0;20,0;2352,0;0,0;18,0;0,0
2020-04-30;Sicilia;408;33;441;1716;2157;12;774;235;3166;79669;74541,0;26,0;4309,0;3,0;11,0;-1,0
2020-05-01;Sicilia;399;30;429;1742;2171;14;786;237;3194;82860;77490,0;28,0;3191,0;2,0;12,0;-3,0
2020-05-02;Sicilia;396;30;426;1760;2186;15;787;240;3213;84352;77590,0;19,0;1492,0;3,0;1,0;0,0
2020-05-03;Sicilia;383;29;412;1791;2203;17;795;242;3240;85955;78409,0;27,0;1603,0;2,0;8,0;-1,0
2020-05-04;Sicilia;376;27;403;1799;2202;-1;809;244;3255;87166;79336,0;15,0;1211,0;2,0;14,0;-2,0
2020-05-05;Sicilia;367;26;393;1809;2202;0;818;247;3267;91306;82079,0;12,0;4140,0;3,0;9,0;-1,0
2020-05-06;Sicilia;359;25;384;1817;2201;-1;830;250;3281;92999;83908,0;14,0;1693,0;3,0;12,0;-1,0
2020-05-07;Sicilia;349;21;370;1757;2127;-74;910;251;3288;95695;85674,0;7,0;2696,0;1,0;80,0;-4,0
2020-05-08;Sicilia;310;19;329;1798;2127;0;921;253;3301;98711;88497,0;13,0;3016,0;2,0;11,0;-2,0
2020-05-09;Sicilia;277;17;294;1786;2080;-47;977;256;3313;101548;90885,0;12,0;2837,0;3,0;56,0;-2,0
2020-05-10;Sicilia;273;16;289;1780;2069;-11;1002;256;3327;102403;91748,0;14,0;855,0;0,0;25,0;-1,0
2020-02-24;Toscana;0;0;0;0;0;0;0;0;0;140;;0,0;140,0;0,0;0,0;0,0
2020-02-25;Toscana;2;0;2;0;2;2;0;0;2;296;;2,0;156,0;0,0;0,0;0,0
2020-02-26;Toscana;2;0;2;0;2;0;0;0;2;363;;0,0;67,0;0,0;0,0;0,0
2020-02-27;Toscana;2;0;2;0;2;0;0;0;2;410;;0,0;47,0;0,0;0,0;0,0
2020-02-28;Toscana;5;0;5;2;7;5;1;0;8;437;;6,0;27,0;0,0;1,0;0,0
2020-02-29;Toscana;7;0;7;3;10;3;1;0;11;531;;3,0;94,0;0,0;0,0;0,0
2020-03-01;Toscana;7;0;7;5;12;2;1;0;13;572;;2,0;41,0;0,0;0,0;0,0
2020-03-02;Toscana;7;0;7;5;12;0;1;0;13;613;;0,0;41,0;0,0;0,0;0,0
2020-03-03;Toscana;10;0;10;8;18;6;1;0;19;697;;6,0;84,0;0,0;0,0;0,0
2020-03-04;Toscana;15;2;17;20;37;19;1;0;38;776;;19,0;79,0;0,0;0,0;2,0
2020-03-05;Toscana;26;3;29;31;60;23;1;0;61;776;;23,0;0,0;0,0;0,0;1,0
2020-03-06;Toscana;35;5;40;38;78;18;1;0;79;1097;;18,0;321,0;0,0;0,0;2,0
2020-03-07;Toscana;54;7;61;51;112;34;1;0;113;1331;;34,0;234,0;0,0;0,0;2,0
2020-03-08;Toscana;91;7;98;67;165;53;1;0;166;1618;;53,0;287,0;0,0;0,0;0,0
2020-03-09;Toscana;107;9;116;90;206;41;1;1;208;2018;;42,0;400,0;1,0;0,0;2,0
2020-03-10;Toscana;91;40;131;129;260;54;3;1;264;2573;;56,0;555,0;0,0;2,0;31,0
2020-03-11;Toscana;87;54;141;173;314;54;5;1;320;2804;;56,0;231,0;0,0;2,0;14,0
2020-03-12;Toscana;100;59;159;193;352;38;7;5;364;3165;;44,0;361,0;4,0;2,0;5,0
2020-03-13;Toscana;134;77;211;244;455;103;10;5;470;4049;;106,0;884,0;0,0;3,0;18,0
2020-03-14;Toscana;160;87;247;367;614;159;10;6;630;4595;;160,0;546,0;1,0;0,0;10,0
2020-03-15;Toscana;175;107;282;481;763;149;10;8;781;5132;;151,0;537,0;2,0;0,0;20,0
2020-03-16;Toscana;175;107;282;559;841;78;11;14;866;5910;;85,0;778,0;6,0;1,0;0,0
2020-03-17;Toscana;329;143;472;552;1024;183;12;17;1053;6727;;187,0;817,0;3,0;1,0;36,0
2020-03-18;Toscana;427;160;587;704;1291;267;17;22;1330;7606;;277,0;879,0;5,0;5,0;17,0
2020-03-19;Toscana;501;178;679;743;1422;131;22;38;1482;8873;;152,0;1267,0;16,0;5,0;18,0
2020-03-20;Toscana;601;189;790;923;1713;291;33;47;1793;10405;;311,0;1532,0;9,0;11,0;11,0
2020-03-21;Toscana;664;202;866;1039;1905;192;35;72;2012;11909;;219,0;1504,0;25,0;2,0;13,0
2020-03-22;Toscana;706;215;921;1223;2144;239;42;91;2277;13264;;265,0;1355,0;19,0;7,0;13,0
2020-03-23;Toscana;838;238;1076;1225;2301;157;51;109;2461;13851;;184,0;587,0;18,0;9,0;23,0
2020-03-24;Toscana;918;244;1162;1357;2519;218;51;129;2699;15701;;238,0;1850,0;20,0;0,0;6,0
2020-03-25;Toscana;999;251;1250;1526;2776;257;54;142;2972;17868;;273,0;2167,0;13,0;3,0;7,0
2020-03-26;Toscana;1037;259;1296;1677;2973;197;95;158;3226;20952;;254,0;3084,0;16,0;41,0;8,0
2020-03-27;Toscana;1053;274;1327;1843;3170;197;103;177;3450;23746;;224,0;2794,0;19,0;8,0;15,0
2020-03-28;Toscana;1093;277;1370;2141;3511;341;108;198;3817;25613;;367,0;1867,0;21,0;5,0;3,0
2020-03-29;Toscana;1111;275;1386;2400;3786;275;121;215;4122;27579;;305,0;1966,0;17,0;13,0;-2,0
2020-03-30;Toscana;1116;279;1395;2655;4050;264;131;231;4412;30099;;290,0;2520,0;16,0;10,0;4,0
2020-03-31;Toscana;1120;293;1413;2813;4226;176;138;244;4608;33165;;196,0;3066,0;13,0;7,0;14,0
2020-04-01;Toscana;1120;297;1417;3015;4432;206;182;253;4867;36575;;259,0;3410,0;9,0;44,0;4,0
2020-04-02;Toscana;1135;295;1430;3359;4789;357;216;268;5273;40724;;406,0;4149,0;15,0;34,0;-2,0
2020-04-03;Toscana;1149;288;1437;3472;4909;120;300;290;5499;44460;;226,0;3736,0;22,0;84,0;-7,0
2020-04-04;Toscana;1129;286;1415;3639;5054;145;310;307;5671;47886;;172,0;3426,0;17,0;10,0;-2,0
2020-04-05;Toscana;1111;276;1387;3798;5185;131;337;325;5847;51006;;176,0;3120,0;18,0;27,0;-10,0
2020-04-06;Toscana;1116;279;1395;3906;5301;116;350;350;6001;52849;;154,0;1843,0;25,0;13,0;3,0
2020-04-07;Toscana;1087;263;1350;4077;5427;126;377;369;6173;56651;;172,0;3802,0;19,0;27,0;-16,0
2020-04-08;Toscana;1066;260;1326;4231;5557;130;430;392;6379;60985;;206,0;4334,0;23,0;53,0;-3,0
2020-04-09;Toscana;1038;256;1294;4409;5703;146;441;408;6552;65461;;173,0;4476,0;16,0;11,0;-4,0
2020-04-10;Toscana;1011;256;1267;4555;5822;119;451;454;6727;72001;;175,0;6540,0;46,0;10,0;0,0
2020-04-11;Toscana;997;237;1234;4758;5992;170;499;467;6958;75756;;231,0;3755,0;13,0;48,0;-19,0
2020-04-12;Toscana;983;238;1221;4941;6162;170;578;495;7235;78640;;277,0;2884,0;28,0;79,0;1,0
2020-04-13;Toscana;992;225;1217;5040;6257;95;615;518;7390;80889;;155,0;2249,0;23,0;37,0;-13,0
2020-04-14;Toscana;1002;225;1227;5125;6352;95;637;538;7527;82269;;137,0;1380,0;20,0;22,0;0,0
2020-04-15;Toscana;977;216;1193;5224;6417;65;693;556;7666;86348;;139,0;4079,0;18,0;56,0;-9,0
2020-04-16;Toscana;940;213;1153;5460;6613;196;745;585;7943;91651;;277,0;5303,0;29,0;52,0;-3,0
2020-04-17;Toscana;898;207;1105;5478;6583;-30;925;602;8110;96231;;167,0;4580,0;17,0;180,0;-6,0
2020-04-18;Toscana;883;198;1081;5389;6470;-113;1149;618;8237;99903;;127,0;3672,0;16,0;224,0;-9,0
2020-04-19;Toscana;852;192;1044;5452;6496;26;1239;637;8372;103975;84620,0;135,0;4072,0;19,0;90,0;-6,0
2020-04-20;Toscana;850;182;1032;5536;6568;72;1272;667;8507;105857;85946,0;135,0;1882,0;30,0;33,0;-10,0
2020-04-21;Toscana;833;171;1004;5618;6622;54;1295;686;8603;109925;87717,0;96,0;4068,0;19,0;23,0;-11,0
2020-04-22;Toscana;820;174;994;5173;6167;-455;1828;705;8700;114100;91747,0;97,0;4175,0;19,0;533,0;3,0
2020-04-23;Toscana;791;168;959;5212;6171;4;1886;723;8780;118177;94426,0;80,0;4077,0;18,0;58,0;-6,0
2020-04-24;Toscana;738;159;897;5236;6133;-38;2002;742;8877;121336;96180,0;97,0;3159,0;19,0;116,0;-9,0
2020-04-25;Toscana;687;166;853;5293;6146;13;2109;760;9015;125495;98753,0;138,0;4159,0;18,0;107,0;7,0
2020-04-26;Toscana;677;158;835;5234;6069;-77;2300;778;9147;127394;99751,0;132,0;1899,0;18,0;191,0;-8,0
2020-04-27;Toscana;671;154;825;5158;5983;-86;2401;795;9179;129048;100869,0;32,0;1654,0;17,0;101,0;-4,0
2020-04-28;Toscana;619;144;763;5133;5896;-87;2524;811;9231;133617;103891,0;52,0;4569,0;16,0;123,0;-10,0
2020-04-29;Toscana;576;139;715;4948;5663;-233;2802;827;9292;137482;106150,0;61,0;3865,0;16,0;278,0;-5,0
2020-04-30;Toscana;546;126;672;4912;5584;-79;2926;842;9352;141849;108596,0;60,0;4367,0;15,0;124,0;-13,0
2020-05-01;Toscana;520;124;644;4729;5373;-211;3218;854;9445;146456;111349,0;93,0;4607,0;12,0;292,0;-2,0
2020-05-02;Toscana;519;118;637;4728;5365;-8;3297;863;9525;148223;112437,0;80,0;1767,0;9,0;79,0;-6,0
2020-05-03;Toscana;513;112;625;4703;5328;-37;3363;872;9563;150914;114354,0;38,0;2691,0;9,0;66,0;-6,0
2020-05-04;Toscana;512;107;619;4660;5279;-49;3441;881;9601;152447;115065,0;38,0;1533,0;9,0;78,0;-5,0
2020-05-05;Toscana;484;111;595;4595;5190;-89;3552;889;9631;157260;118265,0;30,0;4813,0;8,0;111,0;4,0
2020-05-06;Toscana;462;92;554;4534;5088;-102;3670;899;9657;161553;121066,0;26,0;4293,0;10,0;118,0;-19,0
2020-05-07;Toscana;437;91;528;4188;4716;-372;4052;915;9683;166062;124295,0;26,0;4509,0;16,0;382,0;-1,0
2020-05-08;Toscana;399;84;483;4109;4592;-124;4199;930;9721;170296;126752,0;38,0;4234,0;15,0;147,0;-7,0
2020-05-09;Toscana;364;79;443;4005;4448;-144;4360;937;9745;174596;129382,0;24,0;4300,0;7,0;161,0;-5,0
2020-05-10;Toscana;350;78;428;3719;4147;-301;4685;942;9774;178208;131788,0;29,0;3612,0;5,0;325,0;-1,0
2020-02-24;Umbria;0;0;0;0;0;0;0;0;0;0;;0,0;0,0;0,0;0,0;0,0
2020-02-25;Umbria;0;0;0;0;0;0;0;0;0;8;;0,0;8,0;0,0;0,0;0,0
2020-02-26;Umbria;0;0;0;0;0;0;0;0;0;8;;0,0;0,0;0,0;0,0;0,0
2020-02-27;Umbria;0;0;0;0;0;0;0;0;0;8;;0,0;0,0;0,0;0,0;0,0
2020-02-28;Umbria;0;0;0;0;0;0;0;0;0;8;;0,0;0,0;0,0;0,0;0,0
2020-02-29;Umbria;0;0;0;0;0;0;0;0;0;31;;0,0;23,0;0,0;0,0;0,0
2020-03-01;Umbria;0;0;0;2;2;2;0;0;2;35;;2,0;4,0;0,0;0,0;0,0
2020-03-02;Umbria;0;0;0;2;2;0;0;0;2;35;;0,0;0,0;0,0;0,0;0,0
2020-03-03;Umbria;1;1;2;6;8;6;0;0;8;45;;6,0;10,0;0,0;0,0;1,0
2020-03-04;Umbria;1;1;2;7;9;1;0;0;9;58;;1,0;13,0;0,0;0,0;0,0
2020-03-05;Umbria;1;1;2;7;9;0;0;0;9;88;;0,0;30,0;0,0;0,0;0,0
2020-03-06;Umbria;2;2;4;12;16;7;0;0;16;110;;7,0;22,0;0,0;0,0;1,0
2020-03-07;Umbria;2;2;4;20;24;8;0;0;24;134;;8,0;24,0;0,0;0,0;0,0
2020-03-08;Umbria;2;2;4;22;26;2;0;0;26;168;;2,0;34,0;0,0;0,0;0,0
2020-03-09;Umbria;4;2;6;22;28;2;0;0;28;183;;2,0;15,0;0,0;0,0;0,0
2020-03-10;Umbria;8;2;10;27;37;9;0;0;37;260;;9,0;77,0;0,0;0,0;0,0
2020-03-11;Umbria;7;5;12;32;44;7;2;0;46;340;;9,0;80,0;0,0;2,0;3,0
2020-03-12;Umbria;8;8;16;46;62;18;2;0;64;458;;18,0;118,0;0,0;0,0;3,0
2020-03-13;Umbria;11;10;21;52;73;11;2;1;76;576;;12,0;118,0;1,0;0,0;2,0
2020-03-14;Umbria;21;11;32;71;103;30;3;1;107;748;;31,0;172,0;0,0;1,0;1,0
2020-03-15;Umbria;25;13;38;101;139;36;3;1;143;965;;36,0;217,0;0,0;0,0;2,0
2020-03-16;Umbria;30;15;45;114;159;20;4;1;164;1093;;21,0;128,0;0,0;1,0;2,0
2020-03-17;Umbria;36;21;57;135;192;33;4;1;197;1323;;33,0;230,0;0,0;0,0;6,0
2020-03-18;Umbria;54;21;75;166;241;49;4;2;247;1601;;50,0;278,0;1,0;0,0;0,0
2020-03-19;Umbria;69;21;90;238;328;87;4;2;334;1954;;87,0;353,0;0,0;0,0;0,0
2020-03-20;Umbria;75;24;99;285;384;56;4;7;395;2303;;61,0;349,0;5,0;0,0;3,0
2020-03-21;Umbria;92;29;121;326;447;63;5;10;462;2712;;67,0;409,0;3,0;1,0;5,0
2020-03-22;Umbria;97;35;132;368;500;53;5;16;521;3135;;59,0;423,0;6,0;0,0;6,0
2020-03-23;Umbria;106;42;148;408;556;56;5;16;577;3561;;56,0;426,0;0,0;0,0;7,0
2020-03-24;Umbria;105;43;148;476;624;68;5;19;648;4108;;71,0;547,0;3,0;0,0;1,0
2020-03-25;Umbria;123;44;167;519;686;62;5;19;710;4707;;62,0;599,0;0,0;0,0;1,0
2020-03-26;Umbria;144;46;190;580;770;84;12;20;802;5428;;92,0;721,0;1,0;7,0;2,0
2020-03-27;Umbria;149;46;195;629;824;54;39;21;884;6137;;82,0;709,0;1,0;27,0;0,0
2020-03-28;Umbria;159;44;203;695;898;74;43;28;969;7028;;85,0;891,0;7,0;4,0;-2,0
2020-03-29;Umbria;166;46;212;685;897;-1;95;31;1023;7685;;54,0;657,0;3,0;52,0;2,0
2020-03-30;Umbria;173;47;220;614;834;-63;184;33;1051;8150;;28,0;465,0;2,0;89,0;1,0
2020-03-31;Umbria;176;43;219;632;851;17;190;37;1078;8685;;27,0;535,0;4,0;6,0;-4,0
2020-04-01;Umbria;173;45;218;646;864;13;194;37;1095;9080;;17,0;395,0;0,0;4,0;2,0
2020-04-02;Umbria;171;47;218;667;885;21;205;38;1128;9737;;33,0;657,0;1,0;11,0;2,0
2020-04-03;Umbria;165;48;213;707;920;35;220;39;1179;10614;;51,0;877,0;1,0;15,0;1,0
2020-04-04;Umbria;167;44;211;716;927;7;242;41;1210;11809;;31,0;1195,0;2,0;22,0;-4,0
2020-04-05;Umbria;159;45;204;694;898;-29;298;43;1239;12448;;29,0;639,0;2,0;56,0;1,0
2020-04-06;Umbria;159;46;205;667;872;-26;337;44;1253;12573;;14,0;125,0;1,0;39,0;1,0
2020-04-07;Umbria;157;41;198;648;846;-26;368;49;1263;13274;;10,0;701,0;5,0;31,0;-5,0
2020-04-08;Umbria;155;41;196;627;823;-23;416;50;1289;14105;;26,0;831,0;1,0;48,0;0,0
2020-04-09;Umbria;154;38;192;600;792;-31;455;51;1298;15170;;9,0;1065,0;1,0;39,0;-3,0
2020-04-10;Umbria;146;39;185;567;752;-40;498;52;1302;16325;;4,0;1155,0;1,0;43,0;1,0
2020-04-11;Umbria;137;39;176;547;723;-29;534;52;1309;17661;;7,0;1336,0;0,0;36,0;0,0
2020-04-12;Umbria;129;39;168;519;687;-36;580;52;1319;18672;;10,0;1011,0;0,0;46,0;0,0
2020-04-13;Umbria;127;38;165;460;625;-62;643;52;1320;18740;;1,0;68,0;0,0;63,0;-1,0
2020-04-14;Umbria;127;37;164;458;622;-3;646;53;1321;18956;;1,0;216,0;1,0;3,0;-1,0
2020-04-15;Umbria;122;37;159;423;582;-40;686;54;1322;20258;;1,0;1302,0;1,0;40,0;0,0
2020-04-16;Umbria;116;33;149;387;536;-46;738;55;1329;21487;;7,0;1229,0;1,0;52,0;-4,0
2020-04-17;Umbria;111;31;142;352;494;-42;786;57;1337;22818;;8,0;1331,0;2,0;48,0;-2,0
2020-04-18;Umbria;109;32;141;290;431;-63;856;57;1344;24106;;7,0;1288,0;0,0;70,0;1,0
2020-04-19;Umbria;108;30;138;298;436;5;854;58;1348;25170;16790,0;4,0;1064,0;1,0;-2,0;-2,0
2020-04-20;Umbria;113;29;142;282;424;-12;867;58;1349;25562;17099,0;1,0;392,0;0,0;13,0;-1,0
2020-04-21;Umbria;107;22;129;278;407;-17;886;60;1353;26639;17873,0;4,0;1077,0;2,0;19,0;-7,0
2020-04-22;Umbria;97;20;117;254;371;-36;925;61;1357;27655;18679,0;4,0;1016,0;1,0;39,0;-2,0
2020-04-23;Umbria;100;19;119;236;355;-16;946;61;1362;29011;19627,0;5,0;1356,0;0,0;21,0;-1,0
2020-04-24;Umbria;94;19;113;209;322;-33;979;62;1363;30524;20733,0;1,0;1513,0;1,0;33,0;0,0
2020-04-25;Umbria;95;18;113;184;297;-25;1006;63;1366;31939;21842,0;3,0;1415,0;1,0;27,0;-1,0
2020-04-26;Umbria;91;17;108;188;296;-1;1008;64;1368;32569;22320,0;2,0;630,0;1,0;2,0;-1,0
2020-04-27;Umbria;90;16;106;181;287;-9;1018;65;1370;32823;22492,0;2,0;254,0;1,0;10,0;-1,0
2020-04-28;Umbria;80;17;97;178;275;-12;1039;65;1379;33881;23263,0;9,0;1058,0;0,0;21,0;1,0
2020-04-29;Umbria;77;16;93;168;261;-14;1064;66;1391;34937;24079,0;12,0;1056,0;1,0;25,0;-1,0
2020-04-30;Umbria;68;16;84;149;233;-28;1092;67;1392;36459;25317,0;1,0;1522,0;1,0;28,0;0,0
2020-05-01;Umbria;60;13;73;131;204;-29;1121;68;1393;37762;26285,0;1,0;1303,0;1,0;29,0;-3,0
2020-05-02;Umbria;60;13;73;123;196;-8;1130;68;1394;38072;26463,0;1,0;310,0;0,0;9,0;0,0
2020-05-03;Umbria;58;13;71;112;183;-13;1143;68;1394;38823;26973,0;0,0;751,0;0,0;13,0;0,0
2020-05-04;Umbria;56;13;69;112;181;-2;1143;70;1394;39044;27152,0;0,0;221,0;2,0;0,0;0,0
2020-05-05;Umbria;56;11;67;109;176;-5;1154;70;1400;39998;27822,0;6,0;954,0;0,0;11,0;-2,0
2020-05-06;Umbria;55;9;64;107;171;-5;1163;70;1404;41328;28712,0;4,0;1330,0;0,0;9,0;-2,0
2020-05-07;Umbria;47;9;56;85;141;-30;1194;70;1405;42788;29708,0;1,0;1460,0;0,0;31,0;0,0
2020-05-08;Umbria;47;6;53;66;119;-22;1216;71;1406;44223;30704,0;1,0;1435,0;1,0;22,0;-3,0
2020-05-09;Umbria;45;6;51;60;111;-8;1225;71;1407;45574;31679,0;1,0;1351,0;0,0;9,0;0,0
2020-05-10;Umbria;42;6;48;65;113;2;1227;71;1411;46923;32713,0;4,0;1349,0;0,0;2,0;0,0
2020-02-24;Valle d'Aosta;0;0;0;0;0;0;0;0;0;7;;0,0;7,0;0,0;0,0;0,0
2020-02-25;Valle d'Aosta;0;0;0;0;0;0;0;0;0;7;;0,0;0,0;0,0;0,0;0,0
2020-02-26;Valle d'Aosta;0;0;0;0;0;0;0;0;0;7;;0,0;0,0;0,0;0,0;0,0
2020-02-27;Valle d'Aosta;0;0;0;0;0;0;0;0;0;9;;0,0;2,0;0,0;0,0;0,0
2020-02-28;Valle d'Aosta;0;0;0;0;0;0;0;0;0;9;;0,0;0,0;0,0;0,0;0,0
2020-02-29;Valle d'Aosta;0;0;0;0;0;0;0;0;0;9;;0,0;0,0;0,0;0,0;0,0
2020-03-01;Valle d'Aosta;0;0;0;0;0;0;0;0;0;10;;0,0;1,0;0,0;0,0;0,0
2020-03-02;Valle d'Aosta;0;0;0;0;0;0;0;0;0;11;;0,0;1,0;0,0;0,0;0,0
2020-03-03;Valle d'Aosta;0;0;0;0;0;0;0;0;0;12;;0,0;1,0;0,0;0,0;0,0
2020-03-04;Valle d'Aosta;0;0;0;0;0;0;0;0;0;15;;0,0;3,0;0,0;0,0;0,0
2020-03-05;Valle d'Aosta;0;0;0;2;2;2;0;0;2;21;;2,0;6,0;0,0;0,0;0,0
2020-03-06;Valle d'Aosta;0;0;0;7;7;5;0;0;7;28;;5,0;7,0;0,0;0,0;0,0
2020-03-07;Valle d'Aosta;1;0;1;7;8;1;0;0;8;32;;1,0;4,0;0,0;0,0;0,0
2020-03-08;Valle d'Aosta;1;0;1;8;9;1;0;0;9;41;;1,0;9,0;0,0;0,0;0,0
2020-03-09;Valle d'Aosta;4;0;4;11;15;6;0;0;15;67;;6,0;26,0;0,0;0,0;0,0
2020-03-10;Valle d'Aosta;2;0;2;15;17;2;0;0;17;89;;2,0;22,0;0,0;0,0;0,0
2020-03-11;Valle d'Aosta;2;0;2;17;19;2;0;1;20;99;;3,0;10,0;1,0;0,0;0,0
2020-03-12;Valle d'Aosta;7;0;7;19;26;7;0;1;27;118;;7,0;19,0;0,0;0,0;0,0
2020-03-13;Valle d'Aosta;6;0;6;21;27;1;0;1;28;189;;1,0;71,0;0,0;0,0;0,0
2020-03-14;Valle d'Aosta;12;0;12;29;41;14;0;1;42;231;;14,0;42,0;0,0;0,0;0,0
2020-03-15;Valle d'Aosta;10;3;13;43;56;15;0;1;57;230;;15,0;-1,0;0,0;0,0;3,0
2020-03-16;Valle d'Aosta;28;5;33;70;103;47;0;2;105;287;;48,0;57,0;1,0;0,0;2,0
2020-03-17;Valle d'Aosta;35;6;41;93;134;31;0;2;136;398;;31,0;111,0;0,0;0,0;1,0
2020-03-18;Valle d'Aosta;41;3;44;118;162;28;0;3;165;486;;29,0;88,0;1,0;0,0;-3,0
2020-03-19;Valle d'Aosta;47;9;56;153;209;47;0;6;215;608;;50,0;122,0;3,0;0,0;6,0
2020-03-20;Valle d'Aosta;54;9;63;194;257;48;0;7;264;814;;49,0;206,0;1,0;0,0;0,0
2020-03-21;Valle d'Aosta;62;15;77;227;304;47;1;8;313;884;;49,0;70,0;1,0;1,0;6,0
2020-03-22;Valle d'Aosta;63;21;84;270;354;50;1;9;364;950;;51,0;66,0;1,0;0,0;6,0
2020-03-23;Valle d'Aosta;69;20;89;290;379;25;2;12;393;1098;;29,0;148,0;3,0;1,0;-1,0
2020-03-24;Valle d'Aosta;71;20;91;288;379;0;2;19;400;1180;;7,0;82,0;7,0;0,0;0,0
2020-03-25;Valle d'Aosta;70;25;95;280;375;-4;2;24;401;1200;;1,0;20,0;5,0;0,0;5,0
2020-03-26;Valle d'Aosta;73;24;97;281;378;3;2;28;408;1203;;7,0;3,0;4,0;0,0;-1,0
2020-03-27;Valle d'Aosta;91;24;115;298;413;35;2;37;452;1252;;44,0;49,0;9,0;0,0;0,0
2020-03-28;Valle d'Aosta;90;26;116;352;468;55;2;41;511;1380;;59,0;128,0;4,0;0,0;2,0
2020-03-29;Valle d'Aosta;90;26;116;423;539;71;2;43;584;1480;;73,0;100,0;2,0;0,0;0,0
2020-03-30;Valle d'Aosta;92;26;118;400;518;-21;16;50;584;1536;;0,0;56,0;7,0;14,0;0,0
2020-03-31;Valle d'Aosta;91;26;117;435;552;34;20;56;628;1582;;44,0;46,0;6,0;4,0;0,0
2020-04-01;Valle d'Aosta;85;27;112;428;540;-12;32;59;631;1717;;3,0;135,0;3,0;12,0;1,0
2020-04-02;Valle d'Aosta;85;25;110;446;556;16;49;63;668;1934;;37,0;217,0;4,0;17,0;-2,0
2020-04-03;Valle d'Aosta;85;25;110;450;560;4;89;70;719;2106;;51,0;172,0;7,0;40,0;0,0
2020-04-04;Valle d'Aosta;63;23;86;474;560;0;106;82;748;2274;;29,0;168,0;12,0;17,0;-2,0
2020-04-05;Valle d'Aosta;96;23;119;457;576;16;115;91;782;2390;;34,0;116,0;9,0;9,0;0,0
2020-04-06;Valle d'Aosta;109;21;130;437;567;-9;142;96;805;2590;;23,0;200,0;5,0;27,0;-2,0
2020-04-07;Valle d'Aosta;118;17;135;458;593;26;142;100;835;2754;;30,0;164,0;4,0;0,0;-4,0
2020-04-08;Valle d'Aosta;120;20;140;466;606;13;142;102;850;2953;;15,0;199,0;2,0;0,0;3,0
2020-04-09;Valle d'Aosta;118;18;136;473;609;3;154;105;868;3142;;18,0;189,0;3,0;12,0;-2,0
2020-04-10;Valle d'Aosta;131;16;147;455;602;-7;170;107;879;3328;;11,0;186,0;2,0;16,0;-2,0
2020-04-11;Valle d'Aosta;118;17;135;455;590;-12;205;107;902;3464;;23,0;136,0;0,0;35,0;1,0
2020-04-12;Valle d'Aosta;109;16;125;463;588;-2;221;112;921;3510;;19,0;46,0;5,0;16,0;-1,0
2020-04-13;Valle d'Aosta;109;15;124;458;582;-6;230;115;927;3614;;6,0;104,0;3,0;9,0;-1,0
2020-04-14;Valle d'Aosta;112;14;126;433;559;-23;270;118;947;3726;;20,0;112,0;3,0;40,0;-1,0
2020-04-15;Valle d'Aosta;112;11;123;425;548;-11;289;121;958;3894;;11,0;168,0;3,0;19,0;-3,0
2020-04-16;Valle d'Aosta;105;12;117;401;518;-30;331;122;971;4159;;13,0;265,0;1,0;42,0;1,0
2020-04-17;Valle d'Aosta;108;9;117;374;491;-27;379;123;993;4366;;22,0;207,0;1,0;48,0;-3,0
2020-04-18;Valle d'Aosta;107;10;117;432;549;58;400;124;1073;4521;;80,0;155,0;1,0;21,0;1,0
2020-04-19;Valle d'Aosta;102;10;112;450;562;13;401;125;1088;4677;3802,0;15,0;156,0;1,0;1,0;0,0
2020-04-20;Valle d'Aosta;102;8;110;438;548;-14;413;127;1088;4799;3910,0;0,0;122,0;2,0;12,0;-2,0
2020-04-21;Valle d'Aosta;99;8;107;415;522;-26;445;126;1093;4911;3969,0;5,0;112,0;-1,0;32,0;0,0
2020-04-22;Valle d'Aosta;92;8;100;401;501;-21;467;127;1095;5024;4011,0;2,0;113,0;1,0;22,0;0,0
2020-04-23;Valle d'Aosta;91;9;100;363;463;-38;506;127;1096;5227;4133,0;1,0;203,0;0,0;39,0;1,0
2020-04-24;Valle d'Aosta;88;7;95;259;354;-109;617;129;1100;5262;4454,0;4,0;35,0;2,0;111,0;-2,0
2020-04-25;Valle d'Aosta;83;6;89;224;313;-41;657;130;1100;5966;4694,0;0,0;704,0;1,0;40,0;-1,0
2020-04-26;Valle d'Aosta;82;7;89;165;254;-59;721;131;1106;6135;4624,0;6,0;169,0;1,0;64,0;1,0
2020-04-27;Valle d'Aosta;86;7;93;142;235;-19;743;133;1111;6551;4873,0;5,0;416,0;2,0;22,0;0,0
2020-04-28;Valle d'Aosta;81;5;86;123;209;-26;775;135;1119;6897;5069,0;8,0;346,0;2,0;32,0;-2,0
2020-04-29;Valle d'Aosta;78;5;83;52;135;-74;852;137;1124;7181;5337,0;5,0;284,0;2,0;77,0;0,0
2020-04-30;Valle d'Aosta;76;4;80;9;89;-46;902;137;1128;7631;5647,0;4,0;450,0;0,0;50,0;-1,0
2020-05-01;Valle d'Aosta;72;3;75;17;92;3;904;137;1133;7769;5818,0;5,0;138,0;0,0;2,0;-1,0
2020-05-02;Valle d'Aosta;70;3;73;25;98;6;901;137;1136;7951;5931,0;3,0;182,0;0,0;-3,0;0,0
2020-05-03;Valle d'Aosta;74;2;76;33;109;11;895;138;1142;8100;6046,0;6,0;149,0;1,0;-6,0;-1,0
2020-05-04;Valle d'Aosta;74;2;76;34;110;1;894;139;1143;8271;6200,0;1,0;171,0;1,0;-1,0;0,0
2020-05-05;Valle d'Aosta;56;3;59;51;110;0;894;139;1143;8484;6342,0;0,0;213,0;0,0;0,0;1,0
2020-05-06;Valle d'Aosta;50;3;53;74;127;17;880;139;1146;8640;6461,0;3,0;156,0;0,0;-14,0;0,0
2020-05-07;Valle d'Aosta;49;2;51;79;130;3;881;139;1150;8939;6702,0;4,0;299,0;0,0;1,0;-1,0
2020-05-08;Valle d'Aosta;45;2;47;76;123;-7;889;139;1151;9280;6999,0;1,0;341,0;0,0;8,0;0,0
2020-05-09;Valle d'Aosta;45;3;48;70;118;-5;895;139;1152;9443;7130,0;1,0;163,0;0,0;6,0;1,0
2020-05-10;Valle d'Aosta;46;2;48;65;113;-5;905;139;1157;9833;7467,0;5,0;390,0;0,0;10,0;-1,0
2020-02-24;Veneto;12;4;16;16;32;0;0;1;33;2200;;33,0;2200,0;1,0;0,0;4,0
2020-02-25;Veneto;12;7;19;23;42;10;0;1;43;3780;;10,0;1580,0;0,0;0,0;3,0
2020-02-26;Veneto;16;8;24;45;69;27;0;2;71;4900;;28,0;1120,0;1,0;0,0;1,0
2020-02-27;Veneto;19;8;27;82;109;40;0;2;111;6164;;40,0;1264,0;0,0;0,0;0,0
2020-02-28;Veneto;24;9;33;116;149;40;0;2;151;7414;;40,0;1250,0;0,0;0,0;1,0
2020-02-29;Veneto;24;11;35;154;189;40;0;2;191;8659;;40,0;1245,0;0,0;0,0;2,0
2020-03-01;Veneto;51;13;64;197;261;72;0;2;263;9056;;72,0;397,0;0,0;0,0;2,0
2020-03-02;Veneto;53;14;67;204;271;10;0;2;273;9782;;10,0;726,0;0,0;0,0;1,0
2020-03-03;Veneto;49;19;68;229;297;26;7;3;307;10176;;34,0;394,0;1,0;7,0;5,0
2020-03-04;Veneto;76;23;99;246;345;48;9;6;360;10515;;53,0;339,0;3,0;2,0;4,0
2020-03-05;Veneto;92;24;116;264;380;35;17;10;407;11949;;47,0;1434,0;4,0;8,0;1,0
2020-03-06;Veneto;117;27;144;310;454;74;22;12;488;13023;;81,0;1074,0;2,0;5,0;3,0
2020-03-07;Veneto;123;41;164;341;505;51;25;13;543;14429;;55,0;1406,0;1,0;3,0;14,0
2020-03-08;Veneto;146;47;193;430;623;118;29;18;670;15918;;127,0;1489,0;5,0;4,0;6,0
2020-03-09;Veneto;186;51;237;457;694;71;30;20;744;15956;;74,0;38,0;2,0;1,0;4,0
2020-03-10;Veneto;204;67;271;512;783;89;47;26;856;16643;;112,0;687,0;6,0;17,0;16,0
2020-03-11;Veneto;262;68;330;610;940;157;54;29;1023;21400;;167,0;4757,0;3,0;7,0;1,0
2020-03-12;Veneto;360;85;445;852;1297;357;55;32;1384;23438;;361,0;2038,0;3,0;1,0;17,0
2020-03-13;Veneto;366;107;473;980;1453;156;100;42;1595;25691;;211,0;2253,0;10,0;45,0;22,0
2020-03-14;Veneto;366;119;485;1290;1775;322;107;55;1937;26980;;342,0;1289,0;13,0;7,0;12,0
2020-03-15;Veneto;426;129;555;1434;1989;214;120;63;2172;32546;;235,0;5566,0;8,0;13,0;10,0
2020-03-16;Veneto;498;156;654;1620;2274;285;130;69;2473;35052;;301,0;2506,0;6,0;10,0;27,0
2020-03-17;Veneto;548;171;719;1769;2488;214;136;80;2704;35478;;231,0;426,0;11,0;6,0;15,0
2020-03-18;Veneto;646;195;841;2112;2953;465;167;94;3214;40841;;510,0;5363,0;14,0;31,0;24,0
2020-03-19;Veneto;771;209;980;2189;3169;216;200;115;3484;44658;;270,0;3817,0;21,0;33,0;14,0
2020-03-20;Veneto;843;236;1079;2598;3677;508;223;131;4031;49288;;547,0;4630,0;16,0;23,0;27,0
2020-03-21;Veneto;942;249;1191;3023;4214;537;257;146;4617;53642;;586,0;4354,0;15,0;34,0;13,0
2020-03-22;Veneto;1113;255;1368;3276;4644;430;309;169;5122;57671;;505,0;4029,0;23,0;52,0;6,0
2020-03-23;Veneto;1206;281;1487;3499;4986;342;327;192;5505;61115;;383,0;3444,0;23,0;18,0;26,0
2020-03-24;Veneto;1318;304;1622;3729;5351;365;381;216;5948;66178;;443,0;5063,0;24,0;54,0;23,0
2020-03-25;Veneto;1407;316;1723;4022;5745;394;439;258;6442;70877;;494,0;4699,0;42,0;58,0;12,0
2020-03-26;Veneto;1447;326;1773;4367;6140;395;508;287;6935;79759;;493,0;8882,0;29,0;69,0;10,0
2020-03-27;Veneto;1536;338;1874;4774;6648;508;536;313;7497;83627;;562,0;3868,0;26,0;28,0;12,0
2020-03-28;Veneto;1559;344;1903;5010;6913;265;655;362;7930;89380;;433,0;5753,0;49,0;119,0;6,0
2020-03-29;Veneto;1586;355;1941;5310;7251;338;715;392;8358;94784;;428,0;5404,0;30,0;60,0;11,0
2020-03-30;Veneto;1633;356;1989;5575;7564;313;747;413;8724;99941;;366,0;5157,0;21,0;32,0;1,0
2020-03-31;Veneto;1680;356;2036;5814;7850;286;828;477;9155;106238;;431,0;6297,0;64,0;81,0;0,0
2020-04-01;Veneto;1718;350;2068;6156;8224;374;902;499;9625;112746;;470,0;6508,0;22,0;74,0;-6,0
2020-04-02;Veneto;1670;345;2015;6563;8578;354;1001;532;10111;120320;;486,0;7574,0;33,0;99,0;-5,0
2020-04-03;Veneto;1714;335;2049;6812;8861;283;1031;572;10464;126490;;353,0;6170,0;40,0;30,0;-10,0
2020-04-04;Veneto;1691;324;2015;7078;9093;232;1124;607;10824;133289;;360,0;6799,0;35,0;93,0;-11,0
2020-04-05;Veneto;1674;329;2003;7406;9409;316;1186;631;11226;140910;;402,0;7621,0;24,0;62,0;5,0
2020-04-06;Veneto;1714;322;2036;7686;9722;313;1204;662;11588;146288;;362,0;5378,0;31,0;18,0;-7,0
2020-04-07;Veneto;1579;297;1876;8089;9965;243;1265;695;11925;153542;;337,0;7254,0;33,0;61,0;-25,0
2020-04-08;Veneto;1554;285;1839;8332;10171;206;1503;736;12410;163247;;485,0;9705,0;41,0;238,0;-12,0
2020-04-09;Veneto;1530;274;1804;8645;10449;278;1728;756;12933;171456;;523,0;8209,0;20,0;225,0;-11,0
2020-04-10;Veneto;1521;257;1778;8869;10647;198;1981;793;13421;180700;;488,0;9244,0;37,0;253,0;-17,0
2020-04-11;Veneto;1465;251;1716;9033;10749;102;2188;831;13768;190912;;347,0;10212,0;38,0;207,0;-6,0
2020-04-12;Veneto;1428;249;1677;9052;10729;-20;2492;856;14077;198442;;309,0;7530,0;25,0;304,0;-2,0
2020-04-13;Veneto;1427;245;1672;9094;10766;37;2603;882;14251;203077;;174,0;4635,0;26,0;111,0;-4,0
2020-04-14;Veneto;1427;233;1660;9076;10736;-30;2790;906;14432;208878;;181,0;5801,0;24,0;187,0;-12,0
2020-04-15;Veneto;1402;219;1621;9168;10789;53;2895;940;14624;216344;;192,0;7466,0;34,0;105,0;-14,0
2020-04-16;Veneto;1388;209;1597;9203;10800;11;3209;981;14990;224549;;366,0;8205,0;41,0;314,0;-10,0
2020-04-17;Veneto;1359;197;1556;9062;10618;-182;3730;1026;15374;236722;;384,0;12173,0;45,0;521,0;-12,0
2020-04-18;Veneto;1287;190;1477;8967;10444;-174;4189;1059;15692;247329;;318,0;10607,0;33,0;459,0;-7,0
2020-04-19;Veneto;1264;184;1448;8762;10210;-234;4638;1087;15935;255797;161231,0;243,0;8468,0;28,0;449,0;-6,0
2020-04-20;Veneto;1273;180;1453;8608;10061;-149;4954;1112;16127;260810;163757,0;192,0;5013,0;25,0;316,0;-4,0
2020-04-21;Veneto;1230;177;1407;8670;10077;16;5173;1154;16404;268069;167129,0;277,0;7259,0;42,0;219,0;-3,0
2020-04-22;Veneto;1205;163;1368;8623;9991;-86;5566;1181;16738;277543;171735,0;334,0;9474,0;27,0;393,0;-14,0
2020-04-23;Veneto;1189;140;1329;8596;9925;-66;5750;1206;16881;288075;177154,0;143,0;10532,0;25,0;184,0;-23,0
2020-04-24;Veneto;1159;130;1289;8390;9679;-246;6306;1244;17229;296896;181473,0;348,0;8821,0;38,0;556,0;-10,0
2020-04-25;Veneto;1105;129;1234;8198;9432;-247;6671;1288;17391;306977;186426,0;162,0;10081,0;44,0;365,0;-1,0
2020-04-26;Veneto;1097;124;1221;7917;9138;-294;7018;1315;17471;316361;183513,0;80,0;9384,0;27,0;347,0;-5,0
2020-04-27;Veneto;1099;123;1222;7638;8860;-278;7375;1344;17579;320027;192751,0;108,0;3666,0;29,0;357,0;-1,0
2020-04-28;Veneto;1067;120;1187;7414;8601;-259;7699;1408;17708;328218;196864,0;129,0;8191,0;64,0;324,0;-3,0
2020-04-29;Veneto;1042;114;1156;7213;8369;-232;8019;1437;17825;337656;200737,0;117,0;9438,0;29,0;320,0;-6,0
2020-04-30;Veneto;1012;114;1126;7021;8147;-222;8354;1459;17960;349227;206347,0;135,0;11571,0;22,0;335,0;0,0
2020-05-01;Veneto;977;110;1087;6692;7779;-368;8840;1479;18098;362459;212706,0;138,0;13232,0;20,0;486,0;-4,0
2020-05-02;Veneto;970;108;1078;6353;7431;-348;9291;1502;18224;370978;216997,0;126,0;8519,0;23,0;451,0;-2,0
2020-05-03;Veneto;955;103;1058;6241;7299;-132;9503;1516;18318;378202;220598,0;94,0;7224,0;14,0;212,0;-5,0
2020-05-04;Veneto;955;101;1056;6178;7234;-65;9611;1528;18373;383660;223968,0;55,0;5458,0;12,0;108,0;-2,0
2020-05-05;Veneto;926;98;1024;6092;7116;-118;9741;1545;18402;390952;227579,0;29,0;7292,0;17,0;130,0;-3,0
2020-05-06;Veneto;902;90;992;5797;6789;-327;10122;1568;18479;399806;231469,0;77,0;8854,0;23,0;381,0;-8,0
2020-05-07;Veneto;872;87;959;5575;6534;-255;10430;1589;18553;410212;236281,0;74,0;10406,0;21,0;308,0;-3,0
2020-05-08;Veneto;831;79;910;5277;6187;-347;10804;1627;18618;420949;240535,0;65,0;10737,0;38,0;374,0;-8,0
2020-05-09;Veneto;435;40;475;5402;5877;-310;11151;1643;18671;432114;244930,0;53,0;11165,0;16,0;347,0;-39,0
2020-05-10;Veneto;408;37;445;5146;5591;-286;11474;1657;18722;439522;247617,0;51,0;7408,0;14,0;323,0;-3,0
